k ɔ n s uː m ɛ r ɛ	k oː n s uː m ɛ r ɛ
d eː s uː l t oː r j ʊ m	d eː s ʊ l t oː r j ʊ m
k ɔ n s eː kʷ k ɛ n t j a m	k oː n s ɛ kʷ ɛ n t j a m
ɪ n s ɛ ŋ n aː r ɛ	iː n s ɪ ŋ n aː r ɛ
p ɪ s aː r ɛ	p iː n s ɛ r ɛ
ɛ k s eː k r a t j ʊ n ɛ m	ɛ k sː eː k r aː t j oː n ɛ m
g eː r a r k a m	h ɪ ɛ r a r kʰ a m
p uː p ɪ lː a m	p uː p ɪ lː a m
k ɔ n f eː r ɛ r ɛ	k oː n f ɛ rː ɛ
m a r t ɛ lː ʊ m	m a r t ɛ lː ʊ m
a s t uː t j a m	a s t uː t j a m
r ɛ p r ʊ w aː r ɛ	r ɛ p r ɔ b aː r ɛ
a n ɔ d ɪ n ʊ m	a n oː d y n ɔ n
k ɔ m p l ɛ t ʊ m	k ɔ m p l eː t ʊ m
k ɔ n ʊ n g ɪ r ɛ	k ɔ n j ʊ ŋ g ɛ r ɛ
k ɔ n t r a w ɛ n ɪ r ɛ	k ɔ n t r aː w ɛ n iː r ɛ
k ɔ n s ɪ l ʊ m	k ɔ ŋ k ɪ l j ʊ m
m a t ɛ r n ɪ t aː t ɛ m	m aː t ɛ r n ɪ t aː t ɛ m
k ʊ l p a m	k ʊ l p a m
r aː lː ʊ m	r a lː ʊ m
a t r ʊ m	aː t r ʊ m
m ɛ r eː t r ɪ k ɛ	m ɛ r ɛ t r iː k ɛ m
ɪ n g ʊ k t j ʊ n ɛ m	ɪ n j ʊ ŋ k t j oː n ɛ m
f ʊ r n aː k ɛ m	f ɔ r n aː k ɛ m
s p ɛ k uː l a t oː r ɛ	s p ɛ k ʊ l aː t oː r ɛ m
s aʊ l t ʊ m	s ɔ l uː t ʊ m
s uː p ɛ r a w a k a n ɛ ʊ m	s ʊ p ɛ r w a k ʊː m
r ɛ f l ɔ r ɪ r ɛ	r ɛ f l oː r eː r ɛ
k ɔ r w ɪ n ʊ m	k ɔ r w iː n ʊ m
r eː t oː r ɛ	r h eː t ɔ r ɛ m
p r eː m ʊ n ɪ t ʊ r ɛ m	p r aɪ m ɔ n ɪ t oː r ɛ m
n uː m eː r aː r j ʊ m	n ʊ m ɛ r aː r j ʊ m
k r ɔ s t r a m	k r ʊ s t a m
t r ɛ m ɔ l ɛ r ɛ	t r ɛ m ʊ l aː r ɛ
s t ɪ w a r ɛ	s t iː p aː r ɛ
r ɛ lː a k s a t j oː n ɛ m	r ɛ l a k s aː t j oː n ɛ m
p uː s t ʊ l a m	p ʊ s t ʊ l a m
kʷ ɛ r ɛ l a m	kʷ ɛ r eː l a m
a b ɔ m aː s ʊ m	a b ɔ m aː s ʊ m
r ɪ k s a m	r ɪ k s a m
r ɛ k uː r s j ʊ n ɛ m	r ɛ k ʊ r s j oː n ɛ m
a m ɪ g d a l a m	a m y g d a l ʊ m
k ɔ n k r eː t j ɔ n ɛ	k ɔ ŋ k r eː t j oː n ɛ m
ɪ n k ʊ r w aː r ɛ	ɪ ŋ k ʊ r w aː r ɛ
ɪ n t ɛ l ɛ g ɛ r ɛ	ɪ n t ɛ lː ɛ g ɛ r ɛ
p r ɪ m ʊ g ɛ n ɪ t ʊ m	p r iː m oː g ɛ n ɪ t ʊ m
f l a kː ʊ m	f l a kː ʊ m
s a k r ɪ f ɪ k a t oː r ɛ	s a k r ɪ f ɪ k aː t oː r ɛ m
f aː rː ʊ m	f a rː ɛu m
ɪ m p eː r j ɪ aː l ɛ	ɪ m p ɛ r j aː l ɛ m
f ɛ s t ʊ m	f eː s t ʊ m
g uː s t ɪ f ɪ k a t ʊ r ɛ	j uː s t ɪ f ɪ k aː t oː r ɛ m
ɛ k oː k a r ɪ s t j a m	ɛu kʰ a r ɪ s t j a m
w a k uː ɪ t aː t ɛ m	w a k ʊ ɪ t aː t ɛ m
a r ɔ t ʊ m	r uː k t ʊ m
m oː r ɛ m	m oː r ɛ m
a t r ɪ b uː t j ɔ n ɛ	a tː r ɪ b uː t j oː n ɛ m
p r ɔ k ɛ lː a m	p r ɔ k ɛ lː a m
s t uː d j ʊ m	s t ʊ d j ʊ m
s ʊ b s t ɪ t uː t j ʊ n ɛ m	s ʊ b s t ɪ t uː t j oː n ɛ m
a gː l uː t ɪ n r ɛ	a gː l uː t ɪ n aː r ɛ
d uː b ʊ m	d ʊ b j ʊ m
k r ɛ d ɪ b ɪ l ɛ m	k r eː d ɪ b ɪ l ɛ m
k aː lː ɪ d ʊ m	k a lː ɪ d ʊ m
ɪ n mː uː t aː r ɛ	ɪ mː uː t aː r ɛ
k ɛ l j n t ɛ m	k a l ɛ n t ɛ m
l aʊ d ɛ m	l aʊ d ɛ m
a m ɪ k ɪ t j a m	a m iː k ɪ t j a m
p ɔ l ʊ m	p ɔ l ʊ m
ɔ lː aː r j ʊ m	ɔ lː aː r j ʊ m
p r eː t ɛ r n a t uː r a l ɛ	p r aɪ t ɛ r n aː t uː r aː l ɛ m
b a s ɪ l ɪ k a m	b a s ɪ l ɪ k a m
r ɛ s ɔ n aː r ɛ	r ɛ s ɔ n aː r ɛ
w oː l j ɛ r ɛ	w ɛ lː ɛ
r ɛ n ɔ w a t j oː n ɛ	r ɛ n ɔ w aː t j oː n ɛ m
k eː d ɛ r ɛ	k eː d ɛ r ɛ
ɔ t j ʊ m	oː t j ʊ m
p ʊ lː aː r ɛ	p ʊ lː aː r ɛ
t a m ɛ s ʊ m	t a m ɪ s j ʊ m
k ʊ ɪ r ʊ m	k ɔ r j ʊ m
d eː m eː n t ɪ k a r ɛ	d eː m ɛ n t aː r ɛ
t r a n s f ʊ n d ɪ r ɛ	t r aː n s f ʊ n d ɛ r ɛ
a m ɪ k a m	a m iː k a m
k j eː k ʊ m	k aɪ k ʊ m
t j ɪ p ɛ ɪ d ʊ m	t ɛ p ɪ d ʊ m
p ɔ r t j ʊ m	p ɔ r t j oː n ɛ m
s ɔ lː ɪ k ɪ t a t j ʊ n ɛ m	s ɔ lː ɪ k ɪ t aː t j oː n ɛ m
d ɛ s t r uː k k j oː n ɛ m	d eː s t r ʊ k t j oː n ɛ m
a fː l ɪ g ɛ r ɛ	a fː l iː g ɛ r ɛ
k ɔ n t ɛ n t j oː n ɛ m	k ɔ n t ɛ n t j oː n ɛ m
f uː l w ʊ m	f ʊ l w ʊ m
eː kʷ ɪ l ɪ b r j ʊ m	aɪ kʷ ɪ l iː b r j ʊ m
k r ɛ p a t uː r a m	k r ɛ p aː t uː r a m
ɛ k s p lː a n a t j oː n ɛ m	ɛ k s p l aː n aː t j oː n ɛ m
m ɛ r j a m	m ʊ r j a m
b a k ʊ l ʊ m	b a k ʊ l ʊ m
d uː r ʊ m	d uː r ʊ m
k ɔ n s k ɛ ʊ m	k oː n s k j ʊ m
ɪ n k ɪ d ɪ r ɛ	ɪ ŋ k ɪ d ɛ r ɛ
p uː g ɪ l ɛ	p ʊ g ɪ l ɛ m
ɛ s k oː p l ʊ m	s k a l p r ʊ m
d ɪ s t r ɛ ɛ r ɛ	d ɪ s t r a h ɛ r ɛ
ʊ s aː r j ʊ m	uː s w aː r j ʊ m
n ʊ s ʊ k ɔ m j ʊ m	n ɔ s ɔ k ɔ m iː ʊ m
a m ɔ w ɪ b ɪ l ɛ	aː m ɔ w eː r ɛ
d eː ŋ w a n ɛ ɪ r ɛ	eː w aː n eː s k ɛ r ɛ
f iː m b r j aː t ʊ m	f ɪ m b r j aː t ʊ m
ɛ r k ɛ r ɛ	eː r ɪ g ɛ r ɛ
ɪ rː eː g ʊ l aː r ɛ	ɪ rː eː g ʊ l aː r ɛ m
s aː t ɪ r a m	s a t ɪ r a m
m a t r ɪ k ʊ l a m	m aː t r iː k ʊ l a m
a l uː n ʊ m	a l ʊ m n ʊ m
p r a ŋ d s ʊ m	p r a n d j ʊ m
l ɪ t ɛ m	l iː t ɛ m
ɪ n k r ɛ d ɪ b ɪ l ɛ m	ɪ ŋ k r eː d ɪ b ɪ l ɛ m
ɛ k s t r iː n s ɛ k ʊ m	ɛ k s t r iː n s ɛ k ʊ m
k aː m b j aː r ɛ	k a m b iː r ɛ
t ɛ r m ɪ t ɛ m	t a r m ɪ t ɛ m
k ɔ n s oː n aː r ɛ	k oː n s ɔ n aː r ɛ
p r eː g ʊ s t r ɛ	p r aɪ g ʊ s t aː r ɛ
p uː l k r ɪ t uː d ɛ m	p ʊ l kʰ r ɪ t uː d ɪ n ɛ m
f ʊ ŋ g oː s ʊ m	f ʊ ŋ g oː s ʊ m
a t ʊ m	aː t ʊ m
a kː r eː t j oː n ɛ	a kː r eː t j oː n ɛ m
f a s t ɪ d j oː s ʊ m	f a s t iː d j oː s ʊ m
ɪ n t ɛ n p ɛ s t ɪ w ʊ m	ɪ n t ɛ m p ɛ s t iː w ʊ m
r aː s ɛ n aː r ɛ	r ɛ s ɪ ŋ n aː r ɛ
k a t eː k ɪ d k aː r ɛ	k a t eː kʰ iː zː aː r ɛ
l ɪ m a m	l iː m a m
w ɛ r eː k ʊ n d ʊ m	w ɛ r eː k ʊ n d ʊ m
a f lː ɛ n t j a m	a fː l ʊ ɛ n t j a m
a b s ɔ r p t j oː n ɛ m	a b s ɔ r p t j oː n ɛ m
f ɛ rː uː g ɪ n ɛ m	f ɛ rː uː g ɪ n ɛ m
r ɛ kː a t aː r ɛ	r ɛ k a p t j aː r ɛ
p ɛ r w ɛ r t ɪ r ɛ	p ɛ r w ɛ r t ɛ r ɛ
p r eː f eː r ɪ r ɛ	p r aɪ f ɛ rː ɛ
a lː ɪ w j aː r ɛ	a lː ɛ w j aː r ɛ
p r ɛ s ɪ d ɛ r ɛ	p r aɪ s ɪ d eː r ɛ
j uː n j ɪ ɔ r ɛ	j uː n j oː r ɛ m
k ɔ p ɛ r a t j ʊ n ɛ m	k ɔː p ɛ r aː t j oː n ɛ m
l aʊ r ʊ k eː r a s ʊ m	l aʊ r ɔ k ɛ r a s ʊ m
k ʊ r uː s k a r ɛ	k ɔ r ʊ s k aː r ɛ
ɔ b l ɪ g aː r ɛ	ɔ b l ɪ g aː r ɛ
f aː w a m	f a b a m
g uː r ɪ s p r uː d ɛ n s a m	j uː r ɪ s p r uː d ɛ n t j a m
a r b ɪ t r j ʊ m	a r b ɪ t r j ʊ m
d ɔ r aː r ɛ	d ɛ aʊ r aː r ɛ
ɔ l eː r ɛ	ɔ l eː r ɛ
ʊ ŋ g uː l aː t ʊ m	ʊ ŋ g ʊ l aː t ʊ m
f ɔ r m oː s ʊ m	f oː r m oː s ʊ m
n a t j oː n ɛ m	n aː t j oː n ɛ m
a r d ʊ m	a r d ʊː m
h t ɛ d a m	s t a t ɪ k ʊ m
r ɛ k ɛ s ɪ w ʊ m	r ɛ k ɛ sː iː w ʊ m
ɛ k s p eː d j ɛ r ɛ	ɛ k s p ɛ d iː r ɛ
ɛ k s t ɪ r p aː r ɛ	ɛ k sː t ɪ r p aː r ɛ
ɛ k s k l uː ɪ r ɛ	ɛ k s k l uː d ɛ r ɛ
k ɔ n f ɛ s aː r ɛ	k oː n f ɪ t eː r iː
d j ɔ	tʰ iː ʊ m
a n eː l aː r ɛ	a n h eː l aː r ɛ
s eː k uː r ɛ m	s ɛ k uː r ɛ m
k a lː ɛ n d a s	k a l ɛ n d aː s
l uː n aː t ʊ n ɛ m	l uː n aː t j oː n ɛ m
eː lː uː ɛ r ɛ	eː l ʊ ɛ r ɛ
n uː t ʊ m	n uː t ʊ m
k r ɪ m ɪ n a t j oː n ɛ m	k r iː m ɪ n aː t j oː n ɛ m
ɔ b l j ɪ t ɛ r ɛ	ɔ b l iː w ɪ s k iː
p r ɛ p oː s ɪ t ɛ m	p r aɪ p ɔ s ɪ t ʊ m
r eː p uː d j a r ɛ	r ɛ p ʊ d j aː r ɛ
a r k ɪ b ɪ s k ʊ p ʊ m	a r kʰ ɪ ɛ p ɪ s k ɔ p ʊ m
k ɛ n t aʊ r j a m	k ɛ n t aʊ r eːa m
p ɛ r s w a d ɛ r ɛ	p ɛ r s w aː d eː r ɛ
b ʊ lː ɪ r ɛ	b ʊ lː iː r ɛ
f ʊ l g ʊ r aː r ɛ	f ʊ l g ʊ r aː r ɛ
ɛ lː eː g a n t ɛ m	eː l ɛ g a n t ɛ m
s t a t ʊ ɪ r ɛ	s t a t ʊ ɛ r ɛ
l iː n ɛ ʊ m	l iː n ɛu m
n iː n f a m	n y m pʰ a m
a m b ɔ s	a m b oː s
d ɪ s eː m ɪ n aː r ɛ	d ɪ sː eː m ɪ n aː r ɛ
f r aː s k ʊ m	f l a s k oː n ɛ m
k a l ɛ r ɛ	k a l eː r ɛ
n ʊ w ɪ l uː n j ʊ m	n ɔ w ɪ l uː n j ʊ m
r ʊ n k aː r ɛ	r h ɔ ŋ kʰ aː r ɛ
r ɪ k aː l k ɪ t r aː r ɛ	r ɛ k a l k ɪ t r aː r ɛ
s ʊ m ʊ m	s ʊ mː ʊ m
s a ŋ gʷ ɪ n oː s ʊ m	s a ŋ gʷ ɪ n oː s ʊ m
p a l aː r j ɛ m	p a l ɛ aː r j ʊ m
m ɛ n oː r ɛ	m ɪ n oː r ɛ m
m a r a w ɪ l a m	m iː r aː b ɪ l ɛ m
w ʊ g aː r ɛ	w ɔ k aː r ɛ
l uː d ɪ b r j ʊ m	l uː d iː b r j ʊ m
p l a n ɛ t a m	p l a n eː t a m
l ɔ k a t j oː n ɛ	l ɔ k aː t j oː n ɛ m
p ɛ k ʊ r a m	p ɛ k ʊ s
f ʊ r n aː k j a m	f ɔ r n aː k ʊ l a m
m ɛ r ɪ t ʊ m	m ɛ r ɪ t ʊ m
r ɛ s t aː r ɛ	r ɛ s t aː r ɛ
f l uː w j ɪ aː l ɛ	f l ʊ w j aː l ɛ m
k ɔ n s ɛ r w aː r ɛ	k oː n s ɛ r w aː r ɛ
p l aː g j ʊ m	p l a g j ʊ m
w ɛ n d ɛ m j aː r ɛ	w iː n d eː m j aː r ɛ
m ɛ m ɔ r aː r ɛ	m ɛ m ɔ r aː r ɛ
w eː n a oː r ɛ	w eː n aː t oː r ɛ m
j uː r a m ɛ n t ʊ m	j uː r aː m ɛ n t ʊ m
a kː uː s aː b ɛ l ɛ	a kː uː s aː b ɪ l ɛ m
p ʊ l w eː r ɪ k zː aː r ɛ	p ʊ l w ɛ r iː zː aː r ɛ
l ɪ b ɛ lː ʊ m	l ɪ b ɛ lː ʊ m
w ɛ lː ʊ m	w ɪ lː ʊ m
n ɪ m b ʊ m	n ɪ m b ʊ m
a d k uː n t ʊ m	a d j ʊ ŋ k t ʊ m
a d ɔ l ɛ s k ɛ n t j a m	a d ʊ l eː s k ɛ n t j a m
s k r uː t a r ɛ	s k r uː t aː r ɛ
g a rː ɪ r ɛ	g a rː iː r ɛ
l a r d ʊ m	l a r d ʊ m
a fː a s k ɪ n aː r ɛ	f a s k ɪ n aː r ɛ
ɔ p uː l ɛ n t ʊ m	ɔ p ʊ l ɛ n t ʊ m
p uː l w ɪ n a r ɛ	p ʊ l w iː n a r
t r a n s l a t j ʊ n ɛ m	t r aː n s l aː t j oː n ɛ m
k ɛ d uː lː a m	s kʰ ɛ d ʊ l a m
ɪ l j ʊ m	h iː l ʊ m
p a r t ɪ r ɛ	p a r t iː r ɛ
t ɔ g a m	t ɔ g a m
s k ɔ r t a m	s k ɔ r t ɛ a m
f ɛ n eː s t r a m	f ɛ n ɛ s t r a m
k ɔ n d ʊ k iː r ɛ	k ɔ n d iː k ɛ r ɛ
s a k r ɪ l ɛ g ʊ m	s a k r ɪ l ɛ g ʊ m
n ɪ m j ʊ m	n ɪ m j ʊ m
f l ɛ k s j ʊ n ɛ m	f l ɛ k s j oː n ɛ m
t r a n s p ɔ r t aː r ɛ	t r aː n s p ɔ r t aː r ɛ
p a pː aː r ɛ	p a pː aː r ɛ
a d k uː d ɪ k aː r ɛ	a d ɪ uː d ɪ k aː r ɛ
a r t ɛ m iː s j a m	a r t ɛ m ɪ s j a m
ɪ m p ɛ t r aː r ɛ	ɪ m p ɛ t r aː r ɛ
ɔ r aː r ɛ	oː r aː r ɛ
kʷ a l ɪ t aː t ɛ m	kʷ aː l ɪ t aː t ɛ m
t ʊ r p ɛ m	t ʊ r p ɛ m
s t a b ɪ l ɛ ɛ r ɛ	s t a b ɪ l iː r ɛ
m a t r ʊ n aː l ɛ m	m aː t r oː n aː l ɛ m
eː n a rː a t j oː n ɛ m	eː n aː rː aː t j oː n ɛ m
d ɪ s t r ɪ k t ʊ m	d ɪ s t r ɪ k t ʊ m
k ʊ n t uː m aː k ɛ	k ɔ n t ʊ m aː k ɛ m
l ɪ b a r ɛ	l iː b aː r ɛ
s a m aː r ɛ	s aː n aː r ɛ
b aː k a m	b aː k a m
p r ɔ p r ʊ m	p r oː p r j ʊ m
d eː f ɔ r m a t j oː n ɛ	d eː f oː r m aː t j oː n ɛ m
d ɪ s ɔ n aː r ɛ	d ɪ sː ɔ n aː r ɛ
a p ɔ k a l ɪ p s ɛ m	a p ɔ k a l y p s ɛ m
k ɔ k ʊ m	s ɔ kː ʊ m
d eː s ɛ r t j ʊ n ɛ m	d eː s ɛ r t j oː n ɛ m
d ɪ s t ɔ r s j oː n ɛ	d ɪ s t ɔ r t j oː n ɛ m
f ɪ d ʊ m	f iː d ʊ m
a w ʊ l ʊ m	a w j a m
k ɔ ŋ j uː g aː r ɛ	k ɔ n j ʊ g aː r ɛ
m a r g a r ɪ t a m	m a r g a r iː t a m
ɛ k s k r eː t aː r ɛ	ɛ k s k ɛ r n ɛ r ɛ
n j ɛ b l m a m	n ɛ b ʊ l a m
p l aː k ɪ d ʊ m	p l a k ɪ d ʊ m
t j ɛ r t j ʊ m	t ɛ r t j ʊ m
n ɛ kʷ ɪ t j a m	n eː kʷ ɪ t j a m
w eː t ɛ r ɛ m	w ɛ t ɛ r ɛ m
f ʊ t a m	f iː d uː k j a m
a r ɪ j oː lː ʊ m	h a r ɪ ɔ l ʊ m
p ɛ r eː g ʊ n t aː r ɛ	p ɛ r k ɔ n t aː r iː
m a n uː b r j ʊ m	m a n uː b r j ʊ m
n uː k ɪ r ɛ	n ɔ k eː r ɛ
f ɛ s aː r ɛ	f a t eː r iː
r aː m ʊ m	r aː m ʊ m
k ɔ n t ɛ s t aː r ɛ	k ɔ n t ɛ s t aː r iː
ɛ r ɛ d ɛ	h eː r eː d ɛ m
t ɛ t r ɪ k ʊ m	t aɪ t r ɪ k ʊ m
ʊ ŋ t w oː s ʊ m	uː ŋ k t ʊ oː s ʊ m
g a t aː r ɛ	f eː t aː r ɛ
t uː r b a m	t ʊ r b a m
d j a b oː l ɪ k ʊ m	d j a b ɔ l ɪ k ʊ m
a s t a m	h a s t a m
l uː k r aː r ɛ	l ʊ k r aː r iː
s aː k r ʊ m	s a k r ʊ m
f uː n ɪ k ʊ l ʊ m	f uː n ɪ k ʊ l ʊ m
ɔ r b ɪ t ɛ m	ɔ r b ɛ m
n ʊ n k j ʊ m	n uː n t j ʊ m
m ʊ r t aː r j ʊ m	m ɔ r t w aː r j ʊ m
s ɪ b l w ɛ r ɛ	s iː b ɪ l aː r ɛ
l uː m iː n aː r j a m	l uː m ɪ n aː r ɛ
k a d aː w ɛ r ɛ	k a d aː w ɛ r
d eː m a n d aː r ɛ	d eː m a n d aː r ɛ
r uː t j ʊ m	r oː s k ɪ d ʊ m
a l ɔ s a m	a l aʊ s a m
h t aː ŋ g ɛ r ɛ m	t a ŋ g ɛ r ɛ
s kː aː m a m	s kʷ aː m a m
a r gʷ ɛ r ɛ	a r gʷ ɛ r ɛ
p j ɛ n ʊ m	p aɪ aː n ɛ m
m ɛ r ɪ d aː r ɛ	m ɛ r iː d j aː r ɛ
p l ɪ n ɪ t ɛ m	p l eː n ɪ t aː t ɛ m
d eː l uː b r ʊ m	d eː l uː b r ʊ m
eː t ɔ l ɔ g j a m	eː tʰ ɔ l ɔ g j a m
a fː ɛ k t ʊ m	a fː ɛ k t ʊ m
n a rː a t j ʊ m	n aː rː aː t j oː n ɛ m
a p ɪ k k ɛ m	a p ɪ k ɛ m
r a d j a t j oː n ɛ	r a d j aː t j oː n ɛ m
ɪ n k ɔ n s t a n t ɛ m	ɪ ŋ k oː n s t a n t ɛ m
s ʊ w ɛ n ɪ r ɛ	s ʊ b w ɛ n iː r ɛ
m aː pː a m	m a pː a m
d ɪ g ɪ t aː r ɛ	d ɪ g ɪ t aː r ɛ
p r ɔ s ɛ n j ɔ m	p r ɔ s k eː n j ʊ m
ʊ w a m	uː w a m
aː j uː n ʊ m	j eː j uː n j ʊ m
l a m a m	l aː m a m
r ɛ k l ɪ n aː r ɛ	r ɛ k l iː n aː r ɛ
l ɔ r ɪ k a m	l oː r iː k a m
t r eː m r ɛ	t r ɛ m ɛ r ɛ
r ɪ l uː k ɪ r ɛ	r ɛ l uː k eː r ɛ
s t j ɛ r k ʊ m	s t ɛ r k ʊ s
d j ɛ k ɪ m ʊ m	d ɛ k ɪ m ʊ m
w eː ɛ m ɛ n t ɛ m	w ɛ h ɛ m ɛ n t ɛ m
ʊ r ʊ m	uː r ʊ m
r iː s ʊ m	r iː s ʊ m
s uː p uː t aː r ɛ	s ʊ pː ʊ t aː r ɛ
f ɔ n t ɛ m	f ɔ n t ɛ m
l ɛ t ʊ m	l eː k t ʊ m
w ɪ w aː k ɛ	w iː w aː k ɛ m
w ɪ lː aː n ʊ m	w iː lː aː n ʊ m
r ɛ f r ɪ g ɛ r a t j ʊ n ɛ m	r ɛ f r iː g ɛ r aː t j oː n ɛ m
r uː b r ɪ k a m	r ʊ b r iː k a m
ɪ n d ɪ ŋ n ʊ m	ɪ n d iː ŋ n ʊ m
d ɪ s t ɛ ŋ d eː r ɛ	d eː s k ɛ n d ɛ r ɛ
f a b r ɪ k a t j ʊ n ɛ m	f aː b r ɪ k aː t j oː n ɛ m
k ɔ n d uː k ɪ r ɛ	k ɔ n d uː k ɛ r ɛ
ɪ n f ɪ m ʊ m	iː n f ɪ m ʊ m
ɪ sː ɪ m ʊ m	ɪ sː ɪ m ʊ m
a kː uː s aː r ɛ	a kː uː s aː r ɛ
kʷ aː s a r ɛ	kʷ a sː aː r ɛ
eː f ɪ k a t ɪ t aː t ɛ m	ɛ fː ɪ k aː k ɪ t aː t ɛ m
m a t r ɪ m oː n j ʊ m	m aː t r ɪ m oː n j ʊ m
g r aː n ʊ m	g r aː n ʊ m
l uː k j ʊ m	l uː k j ʊ m
ɪ n k ɔ lː uː m ɛ m	ɪ ŋ k ɔ l ʊ m ɛ m
f ɛ k ʊ l ɛ n t ʊ m	f aɪ k ʊ l ɛ n t ʊ m
p a n ɪ k ʊ m	p aː n ɪ k j ʊ m
f l ɔ w	f l ʊ w j ʊ m
a b a l j ɪ eː n aː r ɛ	a b a l ɪ eː n aː r ɛ
ɪ n p r ɔ b ɪ t aː t ɛ m	ɪ m p r ɔ b ɪ t aː t ɛ m
l aʊ r w t ʊ m	l aʊ r ɛ aː t ʊ m
w ɛ s t ɪ t ʊ m	w ɛ s t iː t ʊ m
a lː uː k ɛ	h a lː ʊ m
k ɔ n k uː s j ʊ m	k ɔ ŋ k ʊ sː j oː n ɛ m
f lː ɔ s k uː lː ʊ m	f l ɔ s k ʊ l ʊ m
b oː s k ɛ m	b ɔ s k ʊ m
a t ɛ r a w ʊ m	a k ɛ r w ʊ m
ɪ n t ɛ r w ɛ n t j oː n ɛ m	ɪ n t ɛ r w ɛ n t j oː n ɛ m
n aː w ɛ m	n aː w ɛ m
ɪ n s ɛ r t j oː n ɛ m	iː n s ɛ r t j oː n ɛ m
p a t r j a r k a m	p a t r j a r kʰ a m
p a r t ɪ k ʊ l a m	p a r t ɪ k ʊ l a m
m ɔ t ʊ m	m ʊ tː ʊ m
r ɛ kː l a m a t j oː n ɛ m	r eː k l aː m aː t j oː n ɛ m
k a w a l ɛ r ʊ m	k a b a lː aː r j ʊ m
r ɛ p r ɪ ɛ n s ɪ b ɪ l ɛ m	r ɛ p r ɛ h ɛ n s ɪ b ɪ l ɛ m
a d ʊ r a m eː t ɛ r ɛ	a dː ɔ r m iː s k ɛ r ɛ
a s ɪ l ʊ m	a s y l ʊ m
g ɛ m a m	g ɛ mː a m
ɔ r ɛ k ʊ j a m	ɔ r ɪ k l a m
k ʊ m p r ɪ ɛ n s ɪ w ɪ l ɛ m	k ɔ m p r ɛ h ɛ n s ɪ b ɪ l ɛ m
l a b oː r a t oː r ɛ	l a b oː r aː t oː r ɛ m
l a k r ɪ m oː s ʊ m	l a k r ɪ m oː s ʊ m
m aː l f aː t oː r ɛ	m a l ɛ f a k t oː r ɛ m
k ɔ t r ɪ b ʊ r aː r ɛ	k ɔ n t r ɪ b ʊ l aː r ɛ
s aː r g ʊ m	s a r g ʊ m
p a r ɔ n ɔ m aː s j a m	p a r ɔ n ɔ m a s j a m
p a r t ʊ r j ɛ n	p a r t ʊ r iː r ɛ
d eː r ɪ s oː r ʊ m	d eː r iː s oː r j ʊ m
s ɔ lː ɪ t uː r ɛ m	s oː l ɪ t uː d ɪ n ɛ m
t eː d a m	t aɪ d a m
m uː n ɪ t j ʊ m	m uː n iː t j oː n ɛ m
l a k uː s t r ɛ m	l a k ʊ s t r ɛ m
a b ɪ l ɛ	h a b ɪ l ɛ m
t r ɪ b uː l ʊ m	t r ɪ b ʊ l ʊ m
s ɛ r ɔ t ɪ n ʊ m	s eː r oː t ɪ n ʊ m
ʊ k s w ɛ m	uː ŋ k t j oː n ɛ m
l ɛ ɪ t ʊ m	l aɪ t ʊ m
ɛ k s a s p ɛ r a t j oː n ɛ m	ɛ k s a s p ɛ r aː t j oː n ɛ m
p r ɛ n ʊ m	p r aɪ ŋ n aː t ɛ m
s k ʊ r s ʊ m	ɛ k s k ʊ r s ʊ m
d eː g uː s t aː r ɛ	d eː g ʊ s t aː r ɛ
k ɔ m p l a k ɛ r ɛ	k ɔ m p l a k eː r ɛ
k aː n a m	k a nː a m
m ɛ r g ɛ r ɛ	m ɛ r g ɛ r ɛ
d ɪ k t a m ɛ n	d ɪ k t aː m ɛ n
ɔ s aː r j ʊ m	ɔ sː aː r j ʊ m
a d ɪ r ɛ	a dː ɛ r ɛ
a f j a n t aː r ɛ	a fː ɪ d ɛ n t j aː r ɛ
ɪ m p eː r a t oː r j ʊ m	ɪ m p ɛ r aː t oː r j ʊ m
m ɪ s t uː r a m	m ɪ s t uː r a m
h k a k aː r ɛ	k a p t j aː r ɛ
s p uː r j ʊ m	s p ʊ r j ʊ m
t ɛ m p ɛ r j eː ɛ	t ɛ m p ɛ r ɪ ɛ m
ɪ m p r ʊ b aː r ɛ	ɪ m p r ɔ b aː r ɛ
ɪ n mː uː n ɛ m	ɪ mː uː n ɛ m
k l a m oː r ɛ	k l aː m oː r ɛ m
k a p ɛ lː ʊ m	k a p ɪ lː ʊ m
eː l uː d ɛ r ɛ	eː l uː d ɛ r ɛ
k ɛ n ʊ m	k ɪ nː ʊ m
m a t r ɪ t ɪ d j ʊ m	m aː t r ɪ k iː d j ʊ m
l aː ŋ g oː r ɛ	l a ŋ gʷ oː r ɛ m
w ɛ n t ɪ l a t j oː n ɛ	w ɛ n t ɪ l aː t j oː n ɛ m
d ɪ s t ɔ r kʷ ɛ r ɛ	d ɪ s t ɔ r kʷ eː r ɛ
b a s ɛ m	b a s ɛ m
m ʊ l aː r ɛ	m ɔ lː iː r ɛ
g ɔ d eː r ɛ	g aʊ d eː r ɛ
l uː k s ʊ m	l uː k s ʊ m
p r eː k ɔ n ʊ s k ɛ r ɛ	p r aɪ k ɔ ŋ n ɔ s k ɛ r ɛ
f l oː r ɪ d ʊ m	f l oː r ɪ d ʊ m
d ɪ s p ɛ r s ɛ r ɛ	d ɪ s p ɛ r g ɛ r ɛ
r ɔ ɪ b j a m	r ʊ b j a m
