d ɛ t ɛ n t j oː n ɛ m	d eː t ɛ n t j oː n ɛ m
n ɛ f aː r j ʊ m	n ɛ f aː r j ʊ m
k a l ɪ g a m	k a l ɪ g a m
n ɔ d oː s ʊ m	n oː d oː s ʊ m
s ɛ s kʷ ɪ p ɛ d a l ɛ	s eː s kʷ ɪ p ɛ d aː l ɛ m
d ɛ s t r uː s ʊ eː t k j oː n ɛ m	d eː s t r ʊ k t j oː n ɛ m
k ɛ r t ʊ m	k ɛ r t ʊ m
k ɔ n pː a s ɪ b lː ɛ m	k ɔ m p a sː ɪ b ɪ l ɛ m
aʊ d ɪ t j oː n ɛ	aʊ d iː t j oː n ɛ m
l ɛ m n aː r ʊ m	l ɪ ŋ n aː r j ʊ m
s p uː m aː r ɛ	s p uː m aː r ɛ
ɪ n mː ɔ l a t j ʊ n ɛ m	ɪ mː ɔ l aː t j oː n ɛ m
p r ɔ f ɛ r ɪ r ɛ	p r oː f ɛ rː ɛ
s a g ɪ t aː r j ʊ m	s a g ɪ tː aː r j ʊ m
ɪ n f lː ɪ g ɛ r ɛ	iː n f l iː g ɛ r ɛ
ɪ ŋ gʷ ɪ n ɛ m	ɪ ŋ gʷ ɛ n
ɪ w ʊ m	iː w ʊ m
ɪ n s ɪ ŋ n j a m	iː n s ɪ ŋ n ɛ
l a m p aː r a m	l a m p a d ɛ m
s uː d aː r ɛ	s uː d aː r ɛ
a l t ɛ r k a t j ʊ n ɛ m	a l t ɛ r k aː t j oː n ɛ m
ɪ n s t r uː ɪ r ɛ	iː n s t r ʊ ɛ r ɛ
d ɛ n t aː t ʊ m	d ɛ n t aː t ʊ m
a pː a r aː r ɛ	a pː a r aː r ɛ
l ɪ b ɛ lː ʊ m	l ɪ b ɛ lː ʊ m
l iː n ɛ ʊ m	l iː n ɛu m
f ʊ r n aː k ɛ m	f ɔ r n aː k ɛ m
m uː l ʊ m	m uː l ʊ m
s k a r a b a pʰ ʊ m	s k a r a b aɪ ʊ m
m oː l n aː r ʊ m	m ɔ l iː n aː r j ʊ m
aʊ r ɪ g ɛ r ʊ m	aʊ r ɪ g ɛ r ʊ m
s p ɛ k ɪ f ɪ k ʊ m	s p ɛ k ɪ f ɪ k ʊ m
ɪ s t r uː k s w ɛ m	iː n s t r ʊ k t j oː n ɛ m
k ɔ n m uː t aː r ɛ	k ɔ mː uː t aː r ɛ
p r ɔ d uː k t j oː n ɛ m	p r oː d ʊ k t j oː n ɛ m
s ʊ s p ɪ r ʊ m	s ʊ s p ɪ r j ʊ m
aʊ n ɔ r aː b ɪ l ɛ	h ɔ n oː r aː b ɪ l ɛ m
m a ŋ n ɛ s j ʊ m	m a ŋ n eː s j ʊ m
k ɛ l ɛ r ɛ	k ɛ l ɛ r ɛ m
l a k t aː r ɛ	l a k t aː r ɛ
l ɪ b r aː r ʊ m	l ɪ b r aː r j ʊ m
f a rː aː ɛ k n ɛ	f a rː aː g ɪ n ɛ m
s t uː p eː r ɛ	s t ʊ p eː r ɛ
g r a t ɪ f ɪ k aː r ɛ	g r aː t ɪ f ɪ k aː r iː
f ɔ r t ɛ m	f ɔ r t ɛ m
r ɔ b ɛ r ɛ m	r oː b ʊ r
p ɔ lː aː r ɛ	p ʊ lː aː r ɛ
ɪ n g uː s t ʊ m	ɪ n ɪ uː s t ʊ m
k aː ɪ l aː r ɛ	k ɔ aː g ʊ l aː r ɛ
ɛ s t r ɛ n a m	s t r eː n a m
a s ʊ p t j oː n ɛ m	a sː uː m p t j oː n ɛ m
ɔ n oː r ɛ	h ɔ n oː r ɛ m
t uː r a m	t uː r a m
k ɔ r j ɛ n d ʊ l ʊ m	k ɔ r j a n d r ʊ m
s ʊ r ɪ k ɪ r ɛ	s a r k iː r ɛ
a kː iː d j a m	a k eː d j a m
m a l ɪ ŋ n ʊ m	m a l ɪ ŋ n ʊ m
ɪ n k ɔ m p ɛ t ɛ n t ɛ m	ɪ ŋ k ɔ m p ɛ t ɛ n t ɛ m
k ɪ r k uː m n a w ɪ g aː r ɛ	k ɪ r k ʊ m n aː w ɪ g aː r ɛ
ɪ n t ɛ lː ɛ s ʊ eː t k j oː n ɛ m	ɪ n t ɛ lː ɛ k t j oː n ɛ m
k lː aʊ s uː lː a m	k l aʊ s ʊ l a m
ʊ ŋ t w oː ɪ s ʊ m	uː ŋ k t ʊ oː s ʊ m
r ɪ ɪ s	r ɛ m
ɪ n f ɛ r k ɪ oː r ɛ m	iː n f ɛ r ʊ m
r iː s ɪ d ɛ r ɛ	r ɛ s ɪ d eː r ɛ
aʊ k k j ɔ n ɛ	aʊ k t j oː n ɛ m
s ɛ iː n ʊ m	s ʊ iː n ʊ m
s ʊ s t ɛ n t aː r ɛ	s ʊ s t ɛ n t aː r ɛ
s kʷ aː l ʊ m	s kʷ aː l ʊ m
ɛ w oː r ɛ m	ɛ b ʊ r
s k aː n d ʊ a m	s k a n d ʊ l a m
g aː lː ʊ m	g a lː ʊ m
f aʊ s t ʊ m	f aʊ s t ʊ m
r ɛ f l oː r ɪ r ɛ	r ɛ f l oː r eː r ɛ
t oː r j ʊ m	t oː r j ʊ m
d aː t ʊ m	d a t ʊ m
f uː n ɪ k ʊ l ʊ m	f uː n ɪ k ʊ l ʊ m
ɔ b n uː b ɪ l aː r ɛ	ɔ b n uː b ɪ l aː r ɛ
k ɔ n f ɔ r m ɛ m	k oː n f oː r m ɛ m
ɪ n d ɪ s k r ɛ t j ʊ n ɛ m	ɪ n d ɪ s k r eː t j oː n ɛ m
n ɔ w ɪ t ʊ m	n ɔ w iː k j ʊ m
t r ɪ f ɔ l j aː t ʊ m	t r ɪ f ɔ l j aː t ʊ m
p ɛ r n ɪ k j ɔ s ʊ m	p ɛ r n ɪ k j oː s ʊ m
k ɔ n f ɪ r m a t j ʊ n ɛ m	k oː n f ɪ r m aː t j oː n ɛ m
p ʊ r k ɛ lː ʊ m	p ɔ r k ɛ lː ʊ m
ɪ n t ɛ rː ʊ m p ɛ r ɛ	ɪ n t ɛ rː ʊ m p ɛ r ɛ
a k eː f ɪ l ɛ ʊ m	a kʷ ɪ f ɔ l j ʊ m
s uː b ɪ t ʊ m	s ʊ b ɪ t ʊ m
r eː w ɔ l w ɛ r ɛ	r ɛ w ɔ l w ɛ r ɛ
p ɛ n uː r j a m	p eː n uː r j a m
l a r w a m	l aː r w a m
a s p ɛ r s j ʊ n ɛ m	a s p ɛ r s j oː n ɛ m
k a d uː k ʊ m	k a d uː k ʊ m
m iː n uː a s	m ɪ n uː t j a m
ɛ k s f ɔ lː j aː r ɛ	ɛ k s f oː l j aː r ɛ
p a r a d ɔ k s ʊ m	p a r a d ɔ k s ʊ m
p oː n t oː n ɛ m	p oː t j oː n ɛ m
ɛ t aː t ɛ m	aɪ t aː t ɛ m
z a n k a m	z a ŋ kʰ a m
t r a b aː l j ʊ m	t r ɪ p aː l ɛ m
l ɪ b eː r a t j ʊ n ɛ m	l iː b ɛ r aː t j oː n ɛ m
j uː s t ʊ m	j uː s t ʊ m
g l ɔ s a m	g l ɔ sː a m
a s ɪ s t ɛ r ɛ	a sː ɪ s t ɛ r ɛ
n ɛ g ɔ t j a t j ʊ n ɛ m	n ɛ g oː t j aː t j oː n ɛ m
d ɛ l ɛ t j ʊ n ɛ m	d eː l eː t j oː n ɛ m
a b aː k uː lː ʊ m	a b a k ʊ l ʊ m
ɪ lː uː s t r ɛ m	ɪ lː uː s t r ɛ m
f ɔ r ʊ m	f ɔ r ʊ m
j aː s p ɪ d ɛ m	j a s p ɪ d ɛ m
b l a t ɛ r aː r ɛ	b l a t ɛ r aː r ɛ
r eː w ɛ d r ɛ	r ɛ w ɪ d eː r ɛ
a m ɪ g d a l a m	a m y g d a l ʊ m
uː m uː m	h ʊ m ʊ m
ɪ r a k ʊ n d ʊ m	iː r aː k ʊ n d ʊ m
a r k ɛ t ɪ p ʊ m	a r kʰ ɛ t y p ʊ m
p r ɛ p ɔ s t ɛ r ʊ m	p r aɪ p ɔ s t ɛ r ʊ m
k ɛ r n ɛ r ɛ m	k ɛ r n ɛ r ɛ
n ɪ d ɔ r ɛ	n iː d oː r ɛ m
g r a m a t ɪ k a l ɛ m	g r a mː a t ɪ k aː l ɛ m
k ʊ k ɪ n aː r j ʊ m	k ɔ kʷ iː n aː r j ʊ m
a r g uː t j a m	a r g uː t j a m
b a s t ɛ r n a m	b a s t ɛ r n a m
p ɛ ɪ k t ɪ n aː r ɛ	p ɛ k t ɪ n aː r ɛ
g a l ɛ n a m	g a l eː n a m
f ɛ s aː r ɛ	f a t eː r iː
r ɛ k ɪ t a t j ʊ n ɛ m	r ɛ k ɪ t aː t j oː n ɛ m
m ɔ n ɛ t a m	m ɔ n eː t a m
ʊ m ɪ l j aː r ɛ	h ʊ m ɪ l j aː r ɛ
g r a w aː r ɛ	g r a w aː r ɛ
k ʊ k ɪ n aː r ɛ	k ɔ kʷ iː n aː r ɛ
g ʊ b j n ɛ m	g oː b j ʊ m
d eː s t r uː g ɪ r ɛ	d eː s t r ʊ ɛ r ɛ
a lː ɔ ŋ g aː r ɛ	eː l ɔ ŋ g aː r ɛ
a pː a r ɛ n t ɛ m	a pː a r ɛ n t ɛ m
s t a t uː ɪ r ɛ	s t a t ʊ ɛ r ɛ
t ɛ k s t ʊ m	t ɛ k s t ʊ m
k ɔ n t ɛ n t j oː n ɛ m	k ɔ n t ɛ n t j oː n ɛ m
d eː p ɛ n d ɛ r ɛ	d eː p ɛ n d eː r ɛ
d ɪ g ɪ t aː r ɛ	d ɪ g ɪ t aː r ɛ
d ɛ p ɛ r ɪ k r ɛ	d eː p ɛ r iː r ɛ
a r j ɪ l ɛ	aː r ɛ a l ɛ m
j uː n j ɪ ɔ r ɛ	j uː n j oː r ɛ m
k ɔ n s ɔ r t ɛ m	k oː n s ɔ r t ɛ m
s ɔ n aː r ɛ	s ɔ m n j aː r ɛ
d ɛ s uː m ɪ r ɛ	d eː s uː m ɛ r ɛ
ʊ r ʊ m	uː r ʊ m
ɪ n ɔ w a t j oː n ɛ m	ɪ nː ɔ w aː t j oː n ɛ m
g ɔ k ʊ n d ɪ t eː t ɛ m	j uː k ʊ n d ɪ t aː t ɛ m
w a r j ɪ ɛ t aː t ɛ m	w a r ɪ ɛ t aː t ɛ m
a b r ɛ w j aː r ɛ	a bː r ɛ w j aː r ɛ
ɪ r a k ʊ n d j a m	iː r aː k ʊ n d j a m
a r uː s p ɪ k ɛ m	h a r ʊ s p ɪ k ɛ m
s uː p ɛ r b a m	s ʊ p ɛ r b j a m
a r ɔ m a t ɪ k ʊ m	a r oː m a t ɪ k ʊ m
g ɛ m ɛu pʰ ʊ m	g ɛ m ɛ lː ʊ m
p ɛ r k ɔ l a t j ʊ n ɛ m	p ɛ r k oː l aː t j oː n ɛ m
h ɔ r b ʊ m	ɔ r b ʊ m
k ɔ n f ɛ r ɛ r ɛ	k oː n f ɛ rː ɛ
k ɔ lː ɪ r j ʊ m	k ɔ lː y r j ʊ m
ɔ lː ɔ r ɛ	ɔ l oː r ɛ m
w ɛ r t ɪ g ɪ n oː s ʊ m	w ɛ r t iː g ɪ n oː s ʊ m
k l a r ɪ t aː t ɛ m	k l aː r ɪ t aː t ɛ m
p a l ʊ m b aː r ʊ m	p a l ʊ m b aː r j ʊ m
a k uː m ɛ m	a k uː m ɛ n
a b s t ɛ r g ɛ r ɛ	a b s t ɛ r g eː r ɛ
ɔ n k a m	ʊ ŋ k j a m
p lː a sː ʊ m aː r ɛ	p l a s m aː r ɛ
r a s k aː r ɛ	r aː d ɛ r ɛ
k a n ɔ r ʊ m	k a n oː r ʊ m
ɔ b s t aː r ɛ	ɔ b s t aː r ɛ
s w aː w ɪ t aː t ɛ m	s w aː w ɪ t aː t ɛ m
t oː s ʊ n ɛ m	t oː n s j oː n ɛ m
ɪ n g ɛ n ɛ d r aː r ɛ	ɪ ŋ g ɛ n ɛ r aː r ɛ
r ɛ k l a m aː r ɛ	r ɛ k l aː m aː r ɛ
t aː m ɛ r ɛ	t a k eː r ɛ
f ɪ n ɪ t j ʊ n ɛ m	f iː n iː t j oː n ɛ m
n ʊ m ɛ r ʊ m	n ʊ m ɛ r ʊ m
m eː n s uː r aː r ɛ	m eː n s uː r aː r ɛ
d ɪ s kʷ ɪ s ɪ t j ɔ n ɛ	d ɪ s kʷ iː s iː t j oː n ɛ m
p aː s a r ʊ m	p a sː ɛ r ɛ m
s ɔ lː ɪ k ɪ t uː d ɪ n ɛ m	s ɔ lː ɪ k ɪ t uː d ɪ n ɛ m
k ɔ n t r a w ɛ n ɪ r ɛ	k ɔ n t r aː w ɛ n iː r ɛ
a fː ɪ r m a t j ʊ n ɛ m	a fː ɪ r m aː t j oː n ɛ m
s ɛ kʷ aː k ɛ	s ɛ kʷ aː k ɛ m
r ɛ w ɔ k a t j ʊ n ɛ m	r ɛ w ɔ k aː t j oː n ɛ m
b a r b aː t ʊ m	b a r b aː t ʊ m
ɪ m p r ʊ m t aː r ɛ	p r oː m uː t w aː r iː
m a n g aː r ɛ	m a n d uː k aː r ɛ
ɪ r k ɪ n ʊ m	h ɪ r k iː n ʊ m
a b ɪ t ʊ m	h a b ɪ t ʊ m
ɔ b g ɛ k t ʊ m	ɔ b ɪ ɛ k t ʊ m
ɪ n s ɔ n t ɛ m	iː n s ɔ n t ɛ m
f uː n ɛ m	f uː n ɛ m
a b l uː ɛ r ɛ	a b l ʊ ɛ r ɛ
ɔ n ɔ m a t ɔ p ɛ j a m	ɔ n ɔ m a t ɔ p ɔ ɪ j a m
p a t r j a r k aː t ʊ m	p a t r j a r kʰ a t ʊ m
k ɔ n s ɛ k w ɛ n t j a m	k oː n s ɛ kʷ ɛ n t j a m
p r ɛ n ʊ m	p r aɪ ŋ n aː t ɛ m
ɔ n d aː r ɛ	ʊ n d aː r ɛ
p r ɔ d ɪ g j ɔ s k j ʊ m	p r oː d ɪ g j oː s ʊ m
d ɛ p ɛ r d ɪ t j ʊ n ɛ m	d eː p ɛ r d ɪ t j oː n ɛ m
k ɔ n t r a k t aː r ɛ r ɛ	k ɔ n t r a h ɛ r ɛ
aʊ d aː k j	aʊ d aː k ɛ m
m oː t j ʊ m	m ɔ d j ʊ m
j ɛ t aː r ɛ	j a k t aː r ɛ
ɔ b l ɪ g aː r ɛ	ɔ b l ɪ g aː r ɛ
aʊ d ɪ t oː r ɛ	aʊ d iː t oː r ɛ m
f ɪ g uː r a m	f ɪ g uː r a m
d ɛ s t ɪ n aː r ɛ	d eː s t ɪ n aː r ɛ
s ʊ r g ɪ r ɛ	s ʊ r g ɛ r ɛ
ɪ m p ɔ s ɪ t j ʊ n ɛ m	ɪ m p ɔ s ɪ t j oː n ɛ m
tʰ j ɛ	tʰ iː a m
eː d ɪ k t ʊ m	eː d ɪ k t ʊ m
a n a l ʊ m	a nː aː l ɛ m
d ʊ l k ɪ f ɪ h aː r ɛ	d ʊ l k ɪ f ɪ k aː r ɛ
f a k ʊ n d ʊ m	f aː k ʊ n d ʊ m
ɔ r j ɪ ɛ n t ɛ m	ɔ r ɪ ɛ n t ɛ m
d ɪ s ɛ r t ʊ m	d ɪ s ɛ r t ʊ m
h oː l ʊ m	ɔ l ʊ m
k ɛ r t ɪ t uː d ɪ n ɛ m	k ɛ r t ɪ t uː d ɪ n ɛ m
r ɛ p r ɪ ɛ n d ɛ r ɛ	r ɛ p r ɛ h ɛ n d ɛ r ɛ
p r ɔ l ɔ ŋ g a t j ʊ n ɛ m	p r oː l ɔ ŋ g aː t oː n ɛ m
d ɔ t aː r ɛ	d oː t aː r ɛ
a t kː ʊ ɛ r ɪ r ɛ	a kː w iː r ɛ r ɛ
ɪ ŋ n a r ʊ m	ɪ ŋ n aː r ʊ m
p ɪ k a m	p iː k a m
t ʊ rː ɛ m	t ʊ rː ɛ m
s k uː d ɪ ɛ r ʊ m	s k uː t aː r j ʊ m
b a ʊ m	b a d j ʊ m
s k ʊ r s ʊ m	ɛ k s k ʊ r s ʊ m
r ɪ m aː n ɛ r ɛ	r ɛ m a n eː r ɛ
s ʊ s t ɛ n t aː k ʊ l ʊ m	s ʊ s t ɛ n t aː k ʊ l ʊ m
w w ɔ l a m	w ɪ ɔ l a m
ɔ k k ɪ d ɛ n t ɛ m	ɔ kː ɪ d ɛ n t ɛ m
r ɛ f r ɪ g ɛ r j ʊ m	r eː f r iː g ɛ r j ʊ m
s k a l j aː r	s k aː l aː r ɛ m
t ɪ m ʊ n ɛ m	t eː m oː n ɛ m
l ʊ t r d ʊ m	l uː r ɪ d ʊ m
aɪ s k ʊ l ʊ m	aɪ s k ʊ l ʊ m
ɔ s aː r j ʊ m	ɔ sː aː r j ʊ m
ɪ n w ɛ s t iː r ɛ	ɪ n w ɛ s t iː r ɛ
m a s k ʊ l iː n ʊ m	m a s k ʊ l iː n ʊ m
s k r uː t a r ɛ	s k r uː t aː r ɛ
p ʊ t r ɛ m	p ʊ t r ɛ m
l ʊ k r ɛ	g l oː k iː r ɛ
d ɛ r ɪ s oː r ʊ m	d eː r iː s oː r j ʊ m
n ʊ t r ɪ k ɛ m	n uː t r iː k ɛ m
n ɛ g l ɪ g ɛ n t j a m	n ɛ g l ɛ g ɛ n t j a m
s ɪ m p l ɪ k ɛ m	s ɪ m p l ɪ k ɛ m
w ɪ r aː g ɛ	w ɪ r aː g ɪ n ɛ m
k ɔ s t ɪ t ʊ ɪ r ɛ	k oː n s t ɪ t ʊ ɛ r ɛ
t aʊ r ɪ f ɔ r m ɛ	t aʊ r ɪ f oː r m ɛ m
k ɔ s t ɪ t uː t j ʊ n ɛ m	k oː n s t ɪ t uː t j oː n ɛ m
a r b ɪ t r aː r ɛ	a r b ɪ t r aː r iː
ʊ d a m	uː d ʊ m
s t uː p r ʊ m	s t ʊ p r ʊ m
s pː ɛ t ɪ m ɛ n	s p ɛ k ɪ m ɛ n
s a p oː r ɛ	s a p oː r ɛ m
k ɔ m ɔ d ʊ m	k ɔ mː ɔ d ʊ m
ɛ k s ɪ kː a t j ʊ n ɛ m	ɛ k sː ɪ kː aː t j oː n ɛ m
f aː s j ʊ l a m	f a s k ɪ ɔ l a m
k ɔ k ɔ m ɛ r ʊ m	k ʊ k ʊ m ɛ r ɛ m
f a w oː r ɛ	f a w oː r ɛ m
ɪ n mː ɛ d j aː t ʊ m	ɪ mː ɛ d j aː t ʊ m
g r a l ʊ m	g r aː k ʊ l ʊ m
k a n t aː r ɛ	k a n t aː r ɛ
s k ʊ rː ɛ r ɛ	ɛ k s k ʊ rː ɛ r ɛ
p r ɛ pʰ r ɛ s ɪ l ʊ m	p ɛ t r ɔ s ɛ l iː n ʊ m
n a rː a t j oː n ɛ m	n aː rː aː t ʊ m
ŋ g ɔ s t aː r ɛ	a ŋ g ʊ s t aː r ɛ
a b lː a k t aː r ɛ	a b l a k t aː r ɛ
p ɔ m ʊ m	p oː m ʊ m
g r a k ɪ l ɛ	g r a k ɪ l ɛ m
m ɛ r ɪ d ɪ aː r ɛ	m ɛ r iː d j aː r ɛ
s p ɪ n a l ɛ	s p iː n aː l ɛ m
f ɛ m aː r ɛ l a m	f eː m ɛ lː a m
k ɔ l oː n j a m	k ɔ l oː n j a m
d ɔ l ʊ m	d ɔ l ʊ m
g aː t a m	k a tː a m
a pː ɛ lː aː r ɛ	a pː ɛ lː aː r ɛ
s k ɔ ɛ t ɛ r ɛ	ɛ k s k ɔ kʷ ɛ r ɛ
m uː l t aː r ɛ	m ʊ l t aː r ɛ
k ɪ d j ʊ m	k iː d j ʊ m
g ɔ n f r ɛ	k oː n f l aː r ɛ
ɪ n f ɪ d ɛ r ɛ m	iː n f iː g ɛ r ɛ
p ɛ r s ɛ kʷ ɪ r ɛ	p ɛ r s ɛ kʷ iː
aʊ r ɪ g a m	aʊ r iː g a m
m a l f aː t oː r ɛ	m a l ɛ f a k t oː r ɛ m
a s ɔ lː aː r ɛ	a sː ɔ l aː r ɛ
d ɛ k r ɛ t a l ɛ	d eː k r eː t aː l ɛ m
s uː m g t ʊ m	s uː m p t ʊ m
n ʊ k j j a sː ɛ m	n uː p t j aː s
a lː ɔ k uː t j ʊ n ɛ m	a lː ɔ k uː t j oː n ɛ m
d a ŋ n aː r ɛ	d a m n aː r ɛ
ɪ t ɪ n ɛ r aː r j ʊ m	ɪ t ɪ n ɛ r aː r j ʊ m
d ɛ k ɪ m aː r ɛ	d ɛ k ɪ m aː r ɛ
aː kː sː ɛ m	a k s ɛ m
eː w ɔ l uː t j oː n ɛ	eː w ɔ l uː t j oː n ɛ m
eː k k ɛ l s ʊ m	ɛ k s k ɛ l s ʊ m
k ɛ r t a m ɛ m	k ɛ r t aː m ɛ n
a b j ɛ k t oː n ɛ m	a b ɪ ɛ k t j oː n ɛ m
ɪ n w oː l w ɛ r ɛ m	ɪ n w ɔ l w ɛ r ɛ
a t r ʊ m	aː t r ʊ m
ɪ m b eː b ɪ r ɛ	ɪ m b ɪ b ɛ r ɛ
ɪ n w ɪ t aː r ɛ	ɪ n w iː t aː r ɛ
m ɔ r t aː r j ʊ m	m ɔ r t w aː r j ʊ m
d ɪ s t r ɛ ɛ r ɛ	d ɪ s t r a h ɛ r ɛ
d ɛ k ɛ d ɛ r ɛ	d eː k eː d ɛ r ɛ
r ɛ p r ʊ w aː r ɛ	r ɛ p r ɔ b aː r ɛ
ɛ k s t ɪ r p a t j oː n ɛ	ɛ k sː t ɪ r p aː t j oː n ɛ m
j uː r a m ɛ n t ʊ m	j uː r aː m ɛ n t ʊ m
ɛ k s ɪ g pʰ ʊ m	ɛ k s ɪ gʷ ʊ m
ɪ n s t aʊ r aː r ɛ	iː n s t aʊ r aː r ɛ
s aː t aː r ɪ s f a k t j oː n ɛ m	s a t ɪ s f a k t j oː n ɛ m
r ɛ k uː s aː r ɛ	r ɛ k uː s aː r ɛ
a d m ɔ n ɪ t j ʊ n ɛ m	a d m ɔ n ɪ t j oː n ɛ m
f a b ɛ lː a m	f aː b ɛ lː a m
b ʊ lː a m	b ʊ lː a m
f ɛ n ʊ m	f aɪ n ʊ m
s ɛ p t ɛ n t r j oː n ɛ m	s ɛ p t ɛ n t r j oː n ɛ m
w uː w ʊ m	b uː b oː n ɛ m
ɛ k s k ɔ r j aː r ɛ	ɛ k s k ɔ r j aː r ɛ
p r ɛ d ɔ m ɪ n aː r ɛ	p r aɪ d ɔ m ɪ n aː r iː
r ɛ p t aː r ɛ	r ɛ p ʊ t aː r ɛ
r ɪ p a m	r iː p a m
n a t a l ɪ t j ʊ m	n aː t aː l iː k j ʊ m
k r ɪ n ɛ m	k r iː n ɛ m
n ɛ p eː t ɛ r a m	n ɛ p ɛ t a m
ɪ m ʊ r k a m	a m ʊ r k a m
b ɛ a t ʊ m	b ɔ aː t ʊ m
ɪ n t ɛ r k ɛ d ɛ r ɛ	ɪ n t ɛ r k eː d ɛ r ɛ
s p uː t ʊ m	s p uː t ʊ m
tʰ r aː pː ɪ l ʊ m	d r a pː ʊ m
ʊ n ɪ w ɔ k ʊ m	uː n ɪ w ɔ k ʊ m
ɪ n f a n t j a m	iː n f a n t j a m
p r ɔ r ɪ k ɔ g aː r ɛ	p r oː r ɔ g aː r ɛ
b a r ɪ t n ʊ m	b a r y t ɔ n ʊ m
ɪ n w ɛ t ɛ r aː r ɛ	ɪ n w ɛ t ɛ r aː r ɛ
s a ŋ gʷ ɪ n aː r j ʊ m	s a ŋ gʷ ɪ n aː r j ʊ m
ɪ t uː d ɪ n ɛ m	t uː d ɪ n ɛ m
a m a t ɔ r j ʊ m	a m aː t oː r j ʊ m
aɪ m uː l a t ɔ r ɛ	aɪ m ʊ l aː t oː r ɛ m
p uː l k r ʊ m	p ʊ l kʰ r ʊ m
k ɔ n t ɛ n d ɛ r ɛ	k ɔ n t ɛ n d ɛ r ɛ
n uː m ɛ m	n uː m ɛ n
p r ɛ k ɛ d ɛ r ɛ	p r aɪ k eː d ɛ r ɛ
k ʊ l p a m	k ʊ l p a m
h ɛ r b j aː r j ʊ m	h ɛ r b aː r j ʊ m
p ɛ r f ɪ d ʊ m	p ɛ r f ɪ d ʊ m
l ɔ l t a m	l uː t ɛu m
p r ɛ ɔ kː uː p a t j ʊ n ɛ m	p r aɪ ɔ kː ʊ p aː t j oː n ɛ m
w ɛ rː ɛ k ʊ m	w ɛ rː ɛ m
l ɔ k uː t oː r ɛ	l ɔ k uː t oː r ɛ m
l ʊ n t r a m	l ʊ t r a m
s t a t ɛ r a m	s t a t eː r a m
r ɛ p a r aː r ɛ	r ɛ p a r aː r ɛ
ɪ n s aː n ʊ m	iː n s aː n ʊ m
a n ʊ m	aː n ʊ m
p aː k t ʊ m	p a k t ʊ m
k ɔ n s ɛ r w aː r ɛ	k oː n s ɛ r w aː r ɛ
k ɔ lː ɛ k t j oː n ɛ m	k ɔ lː eː k t j oː n ɛ m
h k ʊ m p l ɛ r ɛ	k ɔ m p l eː r ɛ
a t r a b ɪ lː j aː r j ʊ m	aː t r a b iː l aː r j ʊ m
k a p r iː n ʊ m	k a p r iː n ʊ m
s aː kː uː l ʊ m	s a kː ʊ l ʊ m
a m a n ʊ ɛ n s ɛ m	aː m a n ʊ eː n s ɛ m
k ɔ n w ɛ n j ɛ n t j a m	k ɔ n w ɛ n ɪ ɛ n t j a m
ʊ k s w ɛ m	uː ŋ k t j oː n ɛ m
s uː b ɛ l a m	s uː b ʊ l a m
ɛ k z ɛ m p l aː r ɛ	ɛ k s ɛ m p l aː r ɛ m
ɪ n ɪ kʷ ʊ m	ɪ n iː kʷ ʊ m
ɛ k s k ɔ g ɪ t r ɛ	ɛ k s k oː g ɪ t aː r ɛ
t r ɪ n ɪ t aː t ɛ m	t r iː n ɪ t aː t ɛ m
ɔ l ɪ g aː r k a m	ɔ l ɪ g a r kʰ a m
k ɔ iː t ʊ m	k ɔ ɪ t ʊ m
m a ŋ n ɪ t uː d ʊ m	m a ŋ n ɪ t uː d ɪ n ɛ m
a k ɔ n s ɛ l aː r ɛ	a kː ɔ ŋ k ɪ l j aː r ɛ
k a t ɛ k ɪ s m ʊ m	k a t eː kʰ ɪ s m ʊ m
w ɪ t uː p ɛ r a t j ɔ n ɛ	w ɪ t ʊ p ɛ r aː t j oː n ɛ m
w a k ɪ lː a t j oː n ɛ m	w a k ɪ lː aː t j oː n ɛ m
k ʊ w r ɛ	k ʊ b aː r ɛ
l ɪ k aː t ʊ n ɛ m	l ɪ g aː t j oː n ɛ m
m eː d j aː r ɛ	m ɛ d j aː r ɛ
p a r t ɪ k ʊ l a m	p a r t ɪ k ʊ l a m
t aː ŋ g ɛ r ɛ m	t a ŋ g ɛ r ɛ
r ɛ m uː n ɛ r aː r ɛ	r ɛ m uː n ɛ r aː r ɛ
a n ɛ g aː r ɛ	eː n ɛ k aː r ɛ
s t ʊ pː a m	s t ʊ pː a m
t r aː d ɪ t oː r ɛ	t r aː d ɪ t oː r ɛ m
k eː b aː r ɛ	k ɪ b aː r ɛ
eː m ɔ l uː m ɛ n t ʊ m	eː m ɔ l ʊ m ɛ n t ʊ m
m a s k l ʊ m	m a s k ʊ l ʊ m
s uː pː lː ɪ t j ʊ m	s ʊ pː l ɪ k j ʊ m
ɪ n t ɛ r w ɛ n t j oː n ɛ m	ɪ n t ɛ r w ɛ n t j oː n ɛ m
t eː d a m	t aɪ d a m
l ɛ t ɪ t j a m	l aɪ t ɪ t j a m
s t ʊ l t ʊ m	s t ʊ l t ʊ m
a t ɪ t a m ɛ n t ʊ m	a dː ɪ t aː m ɛ n t ʊ m
m oː r ɛ m	m oː r ɛ m
k ɔ n m ʊ w ɛ r ɛ	k ɔ mː ɔ w eː r ɛ
w a k ɪ lː aː r ɛ	w a k ɪ lː aː r ɛ
ɛ s ʊ m	ɪ p s ʊ m
t ɔ r p ɛ d ʊ m	t ɔ r p eː d ɪ n ɛ m
n a w ɪ fː ʊ m	n aː w ɪ g j ʊ m
r ɛ b ɛ lː aː r ɛ	r ɛ b ɛ lː aː r ɛ
p uː t ʊ m	p ʊ t ʊ m
ɛ m uː l ʊ m	aɪ m ʊ l ʊ m
p ɛ r ɪ k uː s ɔ r ɛ	p ɛ r k ʊ sː oː r ɛ m
b a j aː r ɛ	b aː j ʊ l aː r ɛ
t uː	t uː
s a k r a m ɛ n t a l ɛ	s a k r aː m ɛ n t aː l ɛ m
k a ɛ f aː k eː r ɛ	k a l ɛ f a k ɛ r ɛ
p ɛ kː aː r ɛ	p ɛ kː aː r ɛ
t r a s p ɔ r t aː r ɛ	t r aː n s p ɔ r t aː r ɛ
