ɔ b s ɛ d ɛ r ɛ	ɔ b s ɪ d eː r ɛ
f ɔ r m ɛ m	f oː r m ɛ m
d eː p r ɛ d aː r ɛ	d eː p r aɪ d aː r iː
p a w ɪ d ʊ m	p a w ɪ d ʊ m
k ɔ l ɪ r j ʊ m	k ɔ lː y r j ʊ m
a b ɔ m aː s ʊ m	a b ɔ m aː s ʊ m
k ɔ l oː n j aː ɛ	k ɔ l oː n j a m
t ɛ m p oː r aː r j ʊ m	t ɛ m p ɔ r aː r j ʊ m
f uː r t ʊ m	f uː r t ʊ m
eː fː iː k aː t ɪ t aː t ɛ m	ɛ fː ɪ k aː k ɪ t aː t ɛ m
m a t uː t ʊ n ʊ m	m aː t uː t iː n ʊ m
s k oː p r ʊ m	s k a l p r ʊ m
g oː l a m	g ʊ l a m
p a s t ɪ m n aː k a m	p a s t ɪ n aː k a m
k ɔ aː b ɪ t aː r ɛ	k ɔ h a b ɪ t aː r ɛ
f r a ŋ g ɛ r ɛ	f r a ŋ g ɛ r ɛ
a n aː r k j a m	a n a r kʰ j a m
ɔ l f a t oː r j ʊ m	ɔ l f a k t oː r j ʊ m
oː b l ɪ w j oː n ɛ	ɔ b l iː w j oː n ɛ m
r uː s ɪ n ɔ l ɛ m	l ʊ s k ɪ n j a m
t r aː n s p ɔ r t aː r ɛ	t r aː n s p ɔ r t aː r ɛ
ɪ n f a n t j a m	iː n f a n t j a m
a rː eː p ɛ n t ɛ r ɪ ɛ m	p aɪ n ɪ t eː r ɛ
l a w aː t oː r j ʊ m	l a w aː t oː r j ʊ m
a l a m	aː l ɛ m
p ɛ r ɪ m ɛ r ɛ	p ɛ r ɪ m ɛ r ɛ
p a r g r aː f ʊ m	p a r a g r a pʰ ʊ m
w a g a b ʊ n d ʊ m	w a g aː b ʊ n d ʊ m
j uː d ɪ k aː t oː r ɛ	j uː d ɪ k aː t oː r ɛ m
a g r ɛ s t ɛ m	a g r ɛ s t ɛ m
g a n ɪ r ɛ	g a nː iː r ɛ
s ɔ r t ɛ m	s ɔ r t ɛ m
f ɛ r oː pʰ ʊ m	w ɛ r ɪ k ʊ l ʊ m
k ɔ m p aː t r ɛ m	k ɔ m p a t r ɛ m
p ɛ k oː r a m	p ɛ k ʊ s
s ɪ k oː f a n t a m	s yː k ɔ pʰ a n t a m
eː n ɛ r w aː r ɛ	eː n ɛ r w aː r ɛ
k r aː t ɪ k ʊ l a m	k r aː t ɪ k ʊ l a m
k ɛ l t a m	k ɛ l t a m
ɔ r t ʊ g r aː f j a m	ɔ r tʰ ɔ g r a pʰ j a m
k ɔ n ɛ k s j oː n ɛ m	k ɔ nː ɛ k s j oː n ɛ m
ɪ s a t j aː r ɛ	s a t j aː r ɛ
k a pː l ʊ m	k a p ʊ l ʊ m
eː k s p l oː r aː t oː r ɛ	ɛ k s p l oː r aː t oː r ɛ m
ʊ m iː l j aː r ɛ	h ʊ m ɪ l j aː r ɛ
l oː k ʊ b r ɛ g aː r ɛ	l uː k ʊ b r aː r ɛ
g ɛ m ɪ n aː t j oː n ɛ m	g ɛ m ɪ n aː t j oː n ɛ m
s w a d ɛ r ɛ	s w aː d eː r ɛ
p r ɛ s aː g j aː r ɛ	p r aɪ s aː g iː r ɛ
d aː m ɛ b uː l aː t j oː n ɛ m	d ɛ a m b ʊ l aː t j oː n ɛ m
k a p k j k ʊ m	k a p t j oː s ʊ m
p ɛ l ʊ r ɛ m	p a l ɪ uː r ʊ m
b r aː k aː t ʊ m	b r aː k aː t ʊ m
ɪ l aː r ɛ m	h ɪ l a r ɛ m
b ʊ lː ɪ r ɛ	b ʊ lː iː r ɛ
r uː g iː r ɛ	r uː g iː r ɛ
t ɔ rː aː r ɛ	t ɔ rː eː r ɛ
kʷ ɔ t ɪ d j aː n ʊ m	kʷ ɔ t iː d j aː n ʊ m
b a l t ɛ ʊ m	b a l t ɛu m
k ɔ n d ɛ k ɛ r ɛ	k ɔ n d iː k ɛ r ɛ
l ɪ t ɪ g aː r ɛ	l iː t ɪ g aː r ɛ
w ɛ k s aː r ɛ m	w eː k s aː r ɛ
ɔ d j aː r ɛ	oː d ɪ sː ɛ
d ɛ k r ɛ m ɛ n t ʊ m	d eː k r eː m ɛ n t ʊ m
p ɛ r s aː d ɛ r ɛ	p ɛ r s w aː d eː r ɛ
f uː r ɛ n ʊ m	f uː r ɛ m
s k ʊ m	ɪ s k ʊ m
a r g ɪ lː a m	a r g ɪ lː a m
n ɔ t ʊ m	n ɔ t a m
l ɛ k t ɪ k a m	l ɛ k t iː k a m
h ɛ r eː m ʊ m	ɛ r eː m ʊ m
w ɛ k ɛ m	w ɪ k ɛ m
r iː p a m	r iː p a m
r ɛ l ɪ kʷ j a m	r eː l ɪ kʷ j aː s
s uː p ɪ n ʊ m	s ʊ p iː n ʊ m
ɛ k s p l ɪ k aː t j oː n ɛ m	ɛ k s p l ɪ k aː t j oː n ɛ m
p k r ɔ t r a r ɛ	p r oː t r a h ɛ r ɛ
t eː n t aː r ɛ	t ɛ n t aː r ɛ
k a r n ɛ r ʊ m	k a r n aː r j ʊ m
t ɔ r t oː r ɛ m	t ɔ r t oː r ɛ m
l a m p aː t a m	l a m p a d ɛ m
ɔ n ɔ r ɪ f ɪ k ʊ m	h ɔ n oː r ɪ f ɪ k ʊ m
t ɔ g a m	t ɔ g a m
k aː r m ɪ n aː r ɛ m	k a r m ɪ n aː r ɛ
a n t ɪ s t ɛ r ɛ m	a n t ɪ s t ɪ t ɛ m
k ɔ n f ɪ s k aː r ɛ	k oː n f ɪ s k aː r ɛ
w ɛ r t ɪ g ɪ n oː s ʊ m	w ɛ r t iː g ɪ n oː s ʊ m
aɪ s ɛ kʷ j aː m	ɛ k sː ɛ kʷ j a m
f ɪ s j ʊ n ɛ m	f ɪ sː j oː n ɛ m
f ɔ r t ɪ t uː d ɪ n ɛ m	f ɔ r t ɪ t uː d ɪ n ɛ m
ʊ r l aː r ɛ	ʊ l ʊ l aː r ɛ
t ɛ r t j aː r ɛ	t ɛ r t j aː r ɛ
s ɪ n t aː r ɛ m	s ɛ d eː r ɛ
ɛ k s a k ɛ r b aː t j oː n ɛ m	ɛ k s a k ɛ r b aː t j oː n ɛ m
k ɔ n t ɪ n aː t j oː n ɛ m	k ɔ n t ɪ n w aː t j oː n ɛ m
l a w a t j oː n ɛ m	l a w aː t j oː n ɛ m
d ɛ g ʊ l aː r ɛ	d eː k ɔ lː aː r ɛ
s uː iː n ʊ m	s ʊ iː n ʊ m
ɪ lː uː s t r ɛ m	ɪ lː uː s t r ɛ m
ʊ b iː k aː t j oː n ɛ m	ʊ b ɪ k aː t j oː n ɛ m
h ɔ r k ʊ m	ɔ r k ʊ m
ɪ n t r iː n k ɛ k ʊ m	ɪ n t r iː n s ɛ k ʊ m
d ɪ l ɪ g ɛ n t j a m	d iː l ɪ g ɛ n t j a m
a k s ɪ l j ʊ m	aʊ k s ɪ l j ʊ m
d ɛ p a r t ɪ r ɛ m	d eː p a r t iː r ɛ
k a t ɛ l	k a t ɛ lː a m
g l aʊ k ʊ m	g l aʊ k ʊ m
g r aː t ɪ f ɪ k aː r ɛ	g r aː t ɪ f ɪ k aː r iː
r ɛ l ɛ g aː t j oː n ɛ m	r ɛ l eː g aː t j oː n ɛ m
m eː m b r aː n oː s ʊ m	m ɛ m b r aː n ɛu m
k r ɔ t aː l ʊ m	k r ɔ t a l ʊ m
m ɪ n aː k a m	m ɪ n aː k ɛ m
s ɛ k s ʊ ʊ aː l ɪ t aː t ɛ m	s ɛ k s w aː l ɪ t aː t ɛ m
s t aː b ɪ l ɛ m	s t a b ɪ l ɛ m
k r a p ʊ l a m	k r aː p ʊ l a m
ɪ n t ɛ m p ɛ s t ɪ w ʊ m	ɪ n t ɛ m p ɛ s t iː w ʊ m
p uː l p ɪ t j ʊ m	p ʊ l p ɪ t ʊ m
s ɔ n ʊ m	s ɔ m n ʊ m
r ɛ l ɪ k j a m	r ɛ l ɪ kʷ ʊ m
a pː aː r ɛ n t ɛ m	a pː a r ɛ n t ɛ m
f ɔ t ɪ r ɛ	f ɔ d ɛ r ɛ
p ɛ d ɪ k a m	p ɛ d ɪ k a m
a kː r ɛ s ɛ r ɛ	a kː r eː s k ɛ r ɛ
b ɛ t ʊ l a m	b ɛ t ʊ l a m
a b iː t ʊ aː l ɛ	h a b ɪ t w aː l ɛ m
k a n t ʊ m	k a n t ʊ m
r ɔ g ʊ m	r ɔ g ʊ m
w ʊ l ɛ r ʊ m	w ɛ lː ɛ
t ɛ m ɛ r ɪ t aː t ɛ m	t ɛ m ɛ r ɪ t aː t ɛ m
f r ɪ j ɪ g ɪ d aː t ɛ m	f r iː g ɪ d ɪ t aː t ɛ m
d ɪ s ɛ m n aː r ɛ	d eː s ɪ ŋ n aː r ɛ
p ɛ r k a m	p ɛ r k a m
s a ŋ gʷ ɪ r aː r ɛ	s a ŋ gʷ ɪ n aː r ɛ
r ɛ t j aː r j ʊ m	r eː t j aː r j ʊ m
g ɛ m ɛu l ɛ m	g ɛ m ɛ lː ʊ m
k uː r a t ʊ r a m	k uː r aː t uː r a m
r a p ɪ d ʊ m	r a p ɪ d ʊ m
s ɪ l ɪ k ɛ m	s ɪ l ɪ k ɛ m
r ɛ k ʊ n oː s k ɛ r ɛ	r ɛ k ɔ ŋ n oː s k ɛ r ɛ
t r aː n s f ɛ r ɛ r ɛ	t r aː n s f ɛ rː ɛ
ɪ m aː g ɪ n aː t ɪ w ʊ m	ɪ m aː g ɪ n aː t ɪ w ʊ m
a r uː t a m	r uː t a m
f ʊ l g oː r ɛ m	f ʊ l g oː r ɛ m
d ɪ r aː t uː r a m	d iː r ɛ k t uː r a m
a t w ɛ r t ɪ r ɛ	a d w ɛ r t ɛ r ɛ
s ɔ l aː k ʊ m	s oː l aː k j ʊ m
f ʊ lː ɪ g aː n ɛ	f uː l iː g ɪ n ɛ m
p a s aː r ʊ m	p a sː ɛ r ɛ m
ɔ n ɛ s t ɛ m	h ɔ n ɛ s t aː t ɛ m
h ɔ s t j a m	h ɔ s t j a m
a r m ɪ l a m	a r m ɪ lː a m
w ɛ l a r ɛ	w ɛ l a m
a k t ʊ aː l ɛ	a k t w aː l ɛ m
k ɔ m p r ɪ aː n k ɪ b ɪ l ɛ m	k ɔ m p r ɛ h ɛ n s ɪ b ɪ l ɛ m
s ɛ k r ɛ t ʊ m	s k r iː p t ʊ m
k aʊ d a l ɛ	k aʊ d aː l ɛ m
m a l ɛ d ɪ k ɛ r ɛ	m a l ɛ d iː k ɛ r ɛ
ɪ n s t r ʊ ɪ r ɛ	iː n s t r ʊ ɛ r ɛ
k r uː ɛ n t ʊ m	k r ʊ ɛ n t ʊ m
t r a k j ʊ m	tʰ r aː k j ʊ m
g uː s t ɪ f ɪ k aː t oː r ɛ m	j uː s t ɪ f ɪ k aː t oː r ɛ m
p ʊ r p ʊ r a m	p ʊ r p ʊ r a m
t uː	t uː
d ɪ s ɛ r t ʊ m	d ɪ s ɛ r t ʊ m
k ɔ p j ʊ s ʊ m	k oː p j oː s ʊ m
g uː s t aː t j oː n ɛ m	g ʊ s t aː t j oː n ɛ m
b aː g aː t a m	b l a tː a m
a b ɔ l ɪ t j oː n ɛ m	a b ɔ l ɪ t j oː n ɛ m
d uː r a t j oː n ɛ m	d uː r aː t j oː n ɛ m
eː m aː n k ɪ p aː t j oː n ɛ m	eː m a ŋ k ɪ p aː t j oː n ɛ m
w ɛ n ɛ r aː r ɛ	w ɛ n ɛ r aː r iː
k ɔ m p ɔ r t aː r ɛ m	k ɔ m p ɔ r t aː r ɛ
a n g uː l aː r ɛ	a ŋ g ʊ l aː r ɛ m
f aː rː ɛ g ɛ n ɛ	f a rː aː g ɪ n ɛ m
ɛ r ɛ d aː r ɛ	h eː r eː d ɪ t aː r ɛ
ɔ b t uː s ʊ m	ɔ b t uː s ʊ m
ɪ n t ɛ r k ɪ d ɛ r ɛ	ɪ n t ɛ r k eː d ɛ r ɛ
ɪ n f l ɪ k t j oː n ɛ m	ɪ n f l ɪ k t j oː n ɛ m
k a pː ɛ lː a m	k a pː ɛ lː a m
t a k ɛ r	t a k eː r ɛ
p l aː m aː r ɛ	p l a s m aː r ɛ
s k a n d ɪ r ɛ	s k a n d ɛ r ɛ
t ɔ r w ʊ m	t ɔ r w ʊ m
s a p oː r ɛ	s a p oː r ɛ m
n a t ʊ m	n aː t ʊ m
a b n ʊ ɪ r ɛ	a b n ʊ ɛ r ɛ
k ɔ n s t ɪ t uː t ɪ w ʊ m	k ɔ n s t ɪ t uː t ɪ w ʊ m
s t aː t ʊ m	s t a t ʊ m
t ɛ t r ɪ k ʊ m	t aɪ t r ɪ k ʊ m
s p a r g ɛ r ɛ	s p a r g ɛ r ɛ
ɔ b ɪ ɛ k t ɪ w ʊ m	ɔ b j ɛ k t iː w ʊ m
a pː ɔ r t aː r ɛ	a pː ɔ r t aː r ɛ
f r ɪ m ɪ t ʊ m	f r ɛ m ɪ t ʊ m
l ɪ r ʊ m	g l iː r ɛ m
m a t r ɪ t ɪ d j ʊ m	m aː t r ɪ k iː d j ʊ m
k ɔ n t ʊ r b aː t j oː n ɛ m	k ɔ n t ʊ r b aː t j oː n ɛ m
n a t r ɪ k ɛ m	n aː t r iː k ɛ m
g ɪ b ʊ m	g ɪ bː ʊ m
a n aɪ k ʊ ʊ m	a nː ɪ k ʊ l ʊ m
s a k r ɪ l ɛ g ʊ m	s a k r ɪ l ɛ g ʊ m
t r aɪ m ʊ l ʊ m	t r ɛ m ʊ l ʊ m
ɪ n s ɪ ŋ n j a m	iː n s ɪ ŋ n ɛ
a nː ʊ ɪ r ɛ m	a d n ʊ ɛ r ɛ
t ɔ r t oː m	t ɔ r t j oː n ɛ m
a l iː t ʊ m	h aː l ɪ t ʊ m
m ɔ r ɪ r ɛ	m ɔ r iː
p a r t ɪ k ʊ l a m	p a r t ɪ k ʊ l a m
d ɪ s oː n aː r ɛ	d ɪ sː ɔ n aː r ɛ
ɪ n t ɪ ɛ rː ʊ m p ɛ r ɛ m	ɪ n t ɛ rː ʊ m p ɛ r ɛ
d eː n ɔ m iː n aː r ɛ	d eː n oː m ɪ n aː r ɛ
k ɔ m ɛ r ɛ	k ɔ m ɛ d ɛ r ɛ
ɪ n s t r ʊ k t j ɛ m	iː n s t r ʊ k t j oː n ɛ m
r ɛ k ɛ p t aː r ɛ	r ɛ k ɛ p t aː r ɛ
ɪ m p r ʊ n t aː r ɛ	p r oː m uː t w aː r iː
d ɪ g ɛ s t ɪ w ʊ m	d iː g ɛ s t iː w ʊ m
m ʊ s t ʊ m	m ʊ s t ʊ m
ɔ s p ɪ t j ʊ m	h ɔ s p ɪ t j ʊ m
t r aɪ p ɪ d aː t j oː n ɛ m	t r ɛ p ɪ d aː t j oː n ɛ m
a nː ɪ k ɪ l aː r ɛ	a nː ɪ h ɪ l aː r ɛ
ɔ k k ɪ d ɛ n t ɛ m	ɔ kː ɪ d ɛ n t ɛ m
w ɔ ʊ l aː r ɛ	w ɪ ɔ l aː r ɛ
w ɛ s t ɪ r ɛ	w ɛ s t iː r ɛ
k a r m ɛ m	k a r m ɛ n
f a b r ʊ m	f a b r ʊ m
s a l uː t aː r ɛ	s a l uː t aː r ɛ m
k r ɛ d ʊ l ʊ m	k r eː d ʊ l ʊ m
l a k aː r j ɛ m	l a sː aː r ɛ
a gː r ɛ d ɛ r ɛ	a gː r ɛ d iː
a d ɔ r aː t j oː n ɛ m	a d oː r aː t j oː n ɛ m
d eː d uː k t j oː n ɛ m	d eː d ʊ k t j oː n ɛ m
p r ɔ s ɛ k ɪ r ɛ m	p r oː s ɛ kʷ iː
g a r uː l ʊ m	g a rː ʊ l ʊ m
k aː k aː r ɛ m	k a p t j aː r ɛ
p uː l k r ɪ t ʊ t ɛ m	p ʊ l kʰ r ɪ t uː d ɪ n ɛ m
w a lː ʊ m	w a lː ʊ m
r aɪ s t a m	r ɛ s t ɛ m
w eː n aː r ɛ	w eː n aː r iː
p a p a m	p aː p a m
aɪ r a r j ʊ m	aɪ r aː r j ʊ m
m ɛ s t ʊ m	m aɪ s t ʊ m
ɛ t ʊ m	eː t ʊ m
k a d aː w ɛ r ɛ	k a d aː w ɛ r
d eː l ɪ n kʷ ɛ n t j a m	d eː l ɪ ŋ kʷ ɛ n t j a m
n ɛ g aː r ɛ	n ɛ g aː r ɛ
f r aː t ɛ r n aː l	f r aː t ɛ r n aː l ɛ m
m uː r aː lː a m	m uː r aː l ɛ m
a n ɔ s ʊ m	a nː oː s ʊ m
ɔ l iː g aː r k a m	ɔ l ɪ g a r kʰ a m
a fː j aː n t aː r ɛ	a fː ɪ d ɛ n t j aː r ɛ
ɔ fː iː k ɪ n a m	ɔ fː ɪ k iː n a m
a b j ɪ k t j oː n ɛ m	a b ɪ ɛ k t j oː n ɛ m
f eː n d ɛ r ɛ	f ɪ n d ɛ r ɛ
f ɔ l oː s ʊ m	f ɔ l j oː s ʊ m
n ɛ k s ʊ	n ɛ k s ʊ m
w a s p ɛ r a m	w ɛ s p ɛ r a m
k ɔ r uː s k aː r ɛ	k ɔ r ʊ s k aː r ɛ
t ɛ ɔ s oː f j a m	tʰ ɛ ɔ s ɔ pʰ j a m
f uː g aː k ɛ	f ʊ g aː k ɛ m
ɔ k t a w ʊ m	ɔ k t aː w ʊ m
s ʊ s p ɛ n s j oː n ɛ m	s ʊ s p eː n s j oː n ɛ m
h eː n k ɛ j ʊ m	ɛ k s a g j ʊ m
s ʊ b g ʊ m g aː r ɛ	s ʊ b j ʊ g aː r ɛ
p ɔ m ɪ f ɛ r ʊ m	p oː m ɪ f ɛ r ʊ m
a p j aː r j ʊ m	a p j aː r j ʊ m
k r ɛ t a m	k r eː t a m
k ɔ n t ɛ m p l aː r ɛ	k ɔ n t ɛ m p l aː r iː
a m ɛ t ɪ s t a m	a m ɛ tʰ y s t a m
aʊ s p ɪ t j ʊ m	aʊ s p ɪ k j ʊ m
ɔ n a g r ʊ m	ɔ n a g r ʊ m
k s k ʊ s aː t j oː n ɛ	ɛ k s k uː s aː t j oː n ɛ m
k ɔ ŋ n oː m ɛ n	k oː ŋ n oː m ɛ n
m ʊ l k ɛ r ɛ m	m ʊ l k eː r ɛ
ɪ n uː l t ʊ m	ɪ n ʊ l t ʊ m
s t ɪ m ʊ l aː t j oː n ɛ m	s t ɪ m ʊ l aː t j oː n ɛ m
eː k uː l eː j ʊ m	a k ʊ l ɛu m
w ɔ m ɪ t ʊ m	w ɔ m ɪ t ʊ m
ɪ fː ɛ r w ɛ t ɛ r ɛ	ɛ fː ɛ r w eː s k ɛ r ɛ
a t aː m a n t ɛ m	a d a m a n t ɛ m
ʊ d a m	uː d ʊ m
w ɔ k ɪ f eː r aː r ɛ	w oː k ɪ f ɛ r aː r iː
b a r b aː t ʊ m	b a r b aː t ʊ m
s ɪ l ɪ k j ʊ m	s ɪ l ɪ k j ʊ m
k r ʊ s t aː r ɛ	k r ʊ s t aː r ɛ
p uː n ɪ t j oː n ɛ m	p uː n iː t j oː n ɛ m
p r oː ɛ a m	p r oː r a m
l ɪ n aː r ɛ	l iː n ɛ aː r ɛ
k ɔ n f ɪ r m aː t j oː n ɛ m	k oː n f ɪ r m aː t j oː n ɛ m
m ɛ d ɪ k aː m ɛ n t ʊ m	m ɛ d ɪ k aː m ɛ n t ʊ m
k a m p eː s t r ɛ m	k a m p ɛ s t r ɛ m
p r ɔ p r ɪ ɛ t aː t ɛ m	p r oː p r ɪ ɛ t aː t ɛ m
r ɛ s k iː n d ɛ r ɛ	r ɛ s k ɪ n d ɛ r ɛ
s eː kʷ aː k ɛ	s ɛ kʷ aː k ɛ m
t ɛ d j oː s ʊ m	t aɪ d j oː s ʊ m
k aɪ n ʊ m	k aɪ n ʊ m
d eː l ɪ b eː r aː r ɛ	d eː l iː b ɛ r aː r ɛ
s ɛ k ɛ r m ɛ r ɛ r ɛ	s eː k ɛ r n ɛ r ɛ
f ɪ d ɛ l iː t aː t ɛ m	f ɪ d eː l ɪ t aː t ɛ m
a p ɪ k k ɛ m	a p ɪ k ɛ m
k oː b n aː t ʊ m	k ɔ ŋ n aː t ʊ m
k a t ɛ d r a m	k a tʰ ɛ d r a m
s iː b l w aː r ɛ	s iː b ɪ l aː r ɛ
ɪ ŋ n oː m ɪ n j a m	ɪ ŋ n oː m ɪ n j a m
p a l uː d ɛ m	p a l uː d ɛ m
t r ɛ m ɛ r ɛ	t r ɛ m ɛ r ɛ
a b ɛ t ʊ m	a b ɪ eː t ɛ m
t ɛ s t ɪ m oː n j ʊ m	t ɛ s t ɪ m oː n j ʊ m
w ɛ r m ɛ m	w ɛ r m ɛ m
k iː k ɔ r j aː	k ɪ kʰ ɔ r j ʊ m
m a n ɪ f j eː s t ʊ m	m a n ɪ f ɛ s t ʊ m
m uː s a r aː n a m	m uː s a r aː n ɛu m
ɔ n ɛ ɛ m	ɔ n ʊ s
d ɪ fː ɛ r iː r ɛ	d ɪ fː ɛ rː ɛ
w ɪ t uː p eː r aː t j oː n ɛ m	w ɪ t ʊ p ɛ r aː t j oː n ɛ m
p r w ɛ r a n ʊ m	w eː r
eː kʷ aː n ɪ m ɪ t aː t ɛ m	aɪ kʷ a n ɪ m ɪ t aː t ɛ m
a l ʊ n t l a m	a l aʊ d a m
t r uː k ʊ l ɛ n t ʊ m	t r ʊ k ʊ l ɛ n t ʊ m
w a d oː s ʊ m	w a d oː s ʊ m
p ɪ l aː r ɛ	p ɪ l aː r ɛ
a d iː t ʊ m	a d ɪ t ʊ m
ɪ n k oː l ʊ m ɛ m	ɪ ŋ k ɔ l ʊ m ɛ m
d ɪ m a n aː r ɛ	d iː m aː n aː r ɛ
p r ɔ b l eː m aː t ɪ k ʊ m	p r ɔ b l eː m a t ɪ k ʊ m
p ʊ l s aː r ɛ	p ʊ l s aː r ɛ
d eː s ɪ d ɛ aː r ɛ	d eː s iː d ɛ r aː r ɛ
k ɔ n k a m	k ɔ ŋ kʰ a m
f a a m	f aː g ɛ a m
w eː l oː k ɛ	w eː l oː k ɛ m
p r oː n ʊ m	p r oː n ʊ m
f ɛ d ʊ m	f ɔ ɪ d ʊ s
kʷ r iː b ʊ m	k r iː b r ʊ m
m a t r ɪ m oː n j ʊ m	m aː t r ɪ m oː n j ʊ m
r eː w ɪ n ɪ r ɛ	r ɛ w ɛ n iː r ɛ
a t kː ɛ ɛ r ɪ r ɛ	a kː w iː r ɛ r ɛ
k eː p a m	k aɪ p a m
f ɛ s t ʊ m	f eː s t ʊ m
ʊ s ɛ r ʊ m	ɔ s t j aː r j ʊ m
d ɪ k ɪ m ʊ m	d ɛ k ɪ m ʊ m
ɪ n f ɛ r ɛ r ɛ	iː n f ɛ rː ɛ
l ɛ w ɪ g aː r ɛ	l ɛ w ɪ g aː r ɛ
t r aː n s g r ɛ d ɪ r ɛ	t r aː n s g r ɛ d iː
a n ɔ m aː l ʊ m	a n oː m a l ɔ n
t r aː n s k r ɪ w ɛ r ɛ	t r aː n s k r iː b ɛ r ɛ
s ɪ n ɔ p s ɪ m	s y n ɔ p s ɛ m
ɪ n k ʊ r w aː r ɛ	ɪ ŋ k ʊ r w aː r ɛ
p r aɪ t ɛ n d ɛ r ɛ	p r aɪ t ɛ n d ɛ r ɛ
r ɛ l a k s aː r ɛ	r ɛ l a k s aː r ɛ
ɪ n t ʊ ʊ ɪ ɛ	ɪ n t ʊ eː r iː
l ʊ s k ʊ m	l ʊ s k ʊ m
kʷ ɛ s t j ɔ n aː r j ʊ m	kʷ aɪ s t j oː n aː r j ʊ m
kʷ r iː b l aː r ɛ	k r iː b r aː r ɛ
ɪ w oː r j ʊ m	ɛ b ʊ r
ɛ k s t aː s iː m	ɛ k s t a s ɛ m
p a l p ɪ t aː r ɛ	p a l p ɪ t aː r ɛ
p uː t aː r ɛ	p ʊ t eː r ɛ
k ɔ n d ɪ s k ɛ n d ɛ r ɛ	k ɔ n d eː s k ɛ n d ɛ r ɛ
p r ɔ p aː g aː t j oː n ɛ m	p r oː p aː g aː t j oː n ɛ m
s ɪ n k ɪ p ʊ m	s ɪ ŋ k ɪ p ʊ t
w ɪ p ɛ r a m	w iː p ɛ r a m
kʷ a d r aː r ɛ	kʷ aː d r aː r ɛ
p l aː n ʊ m	p l aː n ʊ m
k ɔ n d ɛ n s aː t j oː n ɛ m	k ɔ n d eː n s aː t j oː n ɛ m
l a r t ʊ m	l a r d ʊ m
s ɔ l ɪ d aː r ɛ	s ɔ l ɪ d aː r ɛ
a m aː n t ɛ m	a m a n t ɛ m
d ɪ s t ɪ lː aː r ɛ	d eː s t ɪ lː aː r ɛ
eː l ɛ n k ʊ m	ɛ l ɛ ŋ kʰ ʊ m
a l ɔ k ʊ t j oː n ɛ m	a lː ɔ k uː t j oː n ɛ m
eː kʷ iː w oː k aː r ɛ	aɪ kʷ ɪ w ɔ k aː r ɛ
a t ɛ n eː r ɛ m	a tː ɪ n eː r ɛ
w ɛ r ɛ r ɛ	w ɛ rː ɛ r ɛ
a kʷ iː l ɪ n ʊ m	a kʷ ɪ l iː n ʊ m
s p ɛ l t a m	s p ɛ l t a m
d ɪ k aː k ɛ	d ɪ k aː k ɛ m
b a p t ɪ s t a m	b a p t ɪ s t a m
p l a n ɪ t ɛ m	p l eː n ɪ t aː t ɛ m
w ɛ r ɪ f iː k aː r ɛ	w eː r ɪ f ɪ k aː r ɛ
aʊ d iː t ɔ r j ʊ m	aʊ d iː t oː r j ʊ m
t r aː n s m ɪ s j oː n ɛ m	t r aː n s m ɪ sː j oː n ɛ m
f a m a m	f aː m a m
d eː w ɪ n ɪ r ɛ	d eː w ɛ n iː r ɛ
a l t ɛ r k aː r ɛ	a l t ɛ r k aː r iː
a m iː k t ʊ m	a m ɪ k t ʊ m
m ɪ s k ɛ l aː n ɛ ʊ m	m ɪ s k ɛ lː aː n ɛu m
r eː w ɛ d aː r ɛ	r ɛ w ɪ d eː r ɛ
k ɔ n ɛ k s j oː n ɛ m	k oː n ɛ k s j oː n ɛ m
a l t ɛ a m	a l tʰ aɪ a m
f r aː t ɛ r n ʊ m	f r aː t ɛ r n ʊ m
k r aɪ m aː r ɛ	k r ɛ m aː r ɛ
m ɔ r d ɛ r ɛ	m ɔ r d eː r ɛ
ɛ k s ɔ r t aː t j oː n ɛ m	ɛ k s h ɔ r t aː t j oː n ɛ m
k ɔ rː oː s j oː n ɛ	k ɔ rː oː s j oː n ɛ m
p ʊ t r ɛ m	p ʊ t r ɛ m
ʊ l t ɛ r j ɔ r ɛ	ʊ l t ɛ r j oː r ɛ m
s ɛ n ɪ k ʊ m	s k eː n ɪ k ʊ m
oː r a r ɛ m	oː r aː r ɛ
b ɛ n ɛ f ɪ k ʊ m	b ɛ n ɛ f ɪ k ʊ m
s ɪ t j ʊ m	s ɪ t ʊ m
r ɛ f ɛ k t j oː n ɛ m	r ɛ f ɛ k t j oː n ɛ m
a b s k ʊ s ʊ m	a b s k ɔ n s ʊ m
ɪ m a t ʊ r ʊ m	ɪ mː aː t uː r ʊ m
s t a t ʊ ɛ r ɛ	s t a t ʊ ɛ r ɛ
p ɔ lː aː r ɛ m	p ʊ lː aː r ɛ
m ɔ r s ʊ m	m ɔ r s ʊ m
r ɛ p ɛ r k uː s j oː n ɛ m	r ɛ p ɛ r k ʊ t ɛ r ɛ
a t l aː n t ɪ k ʊ m	aː t l a n t ɪ k ʊ m
r ɛ l a t ɪ w ʊ m	r ɛ l aː t iː w ʊ m
k ʊ l t ɛ lː ʊ m	k ʊ l t ɛ lː ʊ m
m uː g ɪ t ʊ m	m uː g iː t ʊ m
n a f t a m	n a pʰ tʰ a m
w ʊ l p ɪ n ʊ m	w ʊ l p iː n ʊ m
d eː g r aː d aː t j oː n ɛ m	d eː g r a d aː t j oː n ɛ m
ʊ l t r ɪ k ɛ m	ʊ l t r iː k ɛ m
k ɔ n k ʊ rː ɛ r ɛ	k ɔ ŋ k ʊ rː ɛ r ɛ
k ɪ l ʊ m	k ɪ l j ʊ m
