k ɔ n s iː d ɛ r a t j ʊ m n ɛ m	k oː n s iː d ɛ r aː t j oː n ɛ m
k ɔ n f ɪ j aː r ɛ	k oː n f iː d ɛ r ɛ
iː n uː l t ʊ m	ɪ n ʊ l t ʊ m
s t a b ɪ l ɛ ɛ r ɛ	s t a b ɪ l iː r ɛ
k ɔ n t ɛ n t ʊ m	k ɔ n t ɛ n t ʊ m
f ɛ rː uː g ɛ n ɛ	f ɛ rː uː g ɪ n ɛ m
ɪ w oː r ɛ ʊ m	ɛ b ɔ r ɛu m
ɛ l uː k uː b r aː r ɛ	eː l uː k ʊ b r aː r ɛ
s ɪ r aː	s eː r ʊ m
a k uː s a t oː r ɛ	a kː uː s aː t oː r ɛ m
s uː p ɛ r j oː r ɛ	s ʊ p ɛ r j oː r ɛ m
a m iː g d a l a	a m y g d a l ʊ m
b aː t ʊ m	b ɛ aː t ʊ m
s k ɔ l ʊ m	s k ɔ p ʊ l ʊ m
s k ɔ p a m	s k oː p a m
s a m l iː n a m	s a l iː n a m
a p ɔ r t a m r ɛ	a pː ɔ r t aː r ɛ
r ɛ l ɛ k aː r ɛ	r ɛ l ɪ g aː r ɛ
s ɪ r w ɛ n t ɛ	s ɛ r w ɪ ɛ n t ɛ m
w ɪ k iː n a m	w iː k iː n a m
k ɔ n w ɛ n iː r ɛ	k ɔ n w ɛ n iː r ɛ
n ɪ m b ʊ m	n ɪ m b ʊ m
iː n k l iː t ʊ m	ɪ ŋ k l ɪ t ʊ m
d ɛ w j a t j ʊ m n ɛ m	d eː w j aː t j oː n ɛ m
w a n aː r ɛ	w eː n aː r iː
p r ɛ s t a t j ʊ m n ɛ m	p r aɪ s t aː t j oː n ɛ m
s ɛ r ʊ m	s ɛ r ʊ m
f a r ɛ t r a m	pʰ a r ɛ t r a m
k r iː m iː n aː l ɛ	k r iː m ɪ n aː l ɛ m
ɪ m b ɛ b ɛ r ɛ	ɪ m b ɪ b ɛ r ɛ
m iː ŋ g ɛ r ɛ	m ɪ ŋ g ɛ r ɛ
p r ɔ s ɛ n j ɔ m	p r ɔ s k eː n j ʊ m
a k uː s aː b ɪ l ɛ	a kː uː s aː b ɪ l ɛ m
f a s ɔ l a m	f a s k ɪ ɔ l a m
d ɛ f ɛ m s a m	d eː f ɛ n s a m
r ɛ f r iː g ɛ r a t j ʊ m n ɛ m	r ɛ f r iː g ɛ r aː t j oː n ɛ m
b aː s ʊ m	b aː s j ʊ m
a s ɔ k j aː r ɛ	a sː ɔ k j aː r ɛ
ɛ k s t iː r p aː r ɛ	ɛ k sː t ɪ r p aː r ɛ
iː m p ɛ t iː g ɪ k ɛ m	ɪ m p ɛ t iː g ɪ n ɛ m
t r ʊ w iː s k ʊ m	t ʊ r b ɪ s k ʊ m
n ɔ ɛ w ʊ m	n ɔ w ʊ m
k ɔ ɛ r t ɛ m j ɔ n	k ɔ ɪ r k ɪ t j oː n ɛ m
d ʊ b ɪ t aː r ɛ	d ʊ b ɪ t aː r ɛ
ɔ k k iː d ɛ n t a l ɛ	ɔ kː ɪ d ɛ n t aː l ɛ m
a m gː l ɔ m ɛ r aː r ɛ	a gː l ɔ m ɛ r aː r ɛ
t ɛ n s j oː n ɛ	t eː n s j oː n ɛ m
n uː m ɛ m	n uː m ɛ n
p ɛ t j ʊ m	p iː k ʊ m
p r ɛ a m b ʊ l ʊ m	p r aɪ a m b ʊ l ʊ m
s aː p j ɪ g	s a p ɪ d ʊ m
t ɪ n a m	t ɪ n ɛ a m
m ɔ d ɛ r aː r ɛ	m ɔ d ɛ r aː r iː
ɛ k s p ɔ r t a t j oː n ɛ m	ɛ k s p ɔ r t aː t j oː n ɛ m
n aː w ɛ	n aː w ɛ m
r eː t ɛ n ɛ r ɛ	r ɛ t ɪ n eː r ɛ
b iː b l j ɛ ɔ t ɛ k aː r j ʊ m	b ɪ b l ɪ ɔ tʰ eː k aː r j ʊ m
a p ɔ k a l iː p s ɛ m	a p ɔ k a l y p s ɛ m
g r uː m ʊ m	g r uː m ʊ m
a m n ɔ d iː n ʊ m	a n oː d y n ɔ n
ʊ m l ɪ r ɛ	ɔ l eː r ɛ
ɛ w ɔ l ʊ k w ɛ r ɛ	eː w ɔ l w ɛ r ɛ
s ɔ b r iː n ʊ m	s oː b r iː n ʊ m
ɪ m p r uː m t aː r ɛ	p r oː m uː t w aː r iː
s k r uː p uː l oː s ʊ m	s k r uː p ʊ l oː s ʊ m
a m p l iː f ɪ k aː r ɛ	a m p l ɪ f ɪ k aː r ɛ
kʷ a d r aː r ɛ	kʷ aː d r aː r ɛ
k ɔ lː ɛ m	k ɔ lː ɛ m
m ɛ d iː r	m eː t iː r iː
g aː r f j ʊ m	g r a pʰ j ʊ m
ɔ r n aː r ɛ	oː r n aː r ɛ
l aː b r ʊ m	l a b r ʊ m
g ɪ n h ɪ p eː r ʊ m	j uː n ɪ p ɛ r ʊ m
g iː r aː r ɛ	g y r aː r ɛ
t ɛ r m ɪ t ɛ	t a r m ɪ t ɛ m
m ɔ lː eː t a m	m ɔ lː ɪ t j a m
f aː k t oː r ɛ	f a k t oː r ɛ m
k ɛ m ɛ n t ʊ m	k aɪ m ɛ n t ʊ m
kʷ ɛ r iː m ɔ n j a m	kʷ ɛ r ɪ m oː n j a m
ɪ t aː t ɛ m	t a t ɛ m
a m p r iː r ɛ	a p ɛ r iː r ɛ
a b a l j ɪ ɛ n aː r ɛ	a b a l ɪ eː n aː r ɛ
k ɔ n ɛ k t ɛ r ɛ	k oː n ɛ k t ɛ r ɛ
r oː t ɛ lː a m	r ɔ t ɛ lː a m
k ʊ m n k a m t ɛ n a m r ɛ	k ɔ ŋ k a t eː n aː r ɛ
f l ɛ k s j ʊ m n ɛ m	f l ɛ k s j oː n ɛ m
p a l p iː t a t j oː n	p a l p ɪ t aː t j oː n ɛ m
p l uː m a m	p l uː m a m
uː m iː l j a m t j ʊ m n ɛ m	h ʊ m ɪ l j aː t j oː n ɛ m
m w ɛ l a m r ɛ	eː w ɪ g ɪ l aː r ɛ
d iː m ɪ t ɪ r ɛ	d iː m ɪ tː ɛ r ɛ
s ɛ h ɪ lː aː r	s ɪ g ɪ lː aː r ɛ
aʊ g uː r j ʊ m	aʊ g ʊ r j ʊ m
kʷ aː d r ʊ m	kʷ aː d r ʊ m
l ɔ t r d ʊ m	l uː r ɪ d ʊ m
ɛ lː iː p s ɪ	ɛ lː iː p s ɪ n
w aː t ɛ	w aː t ɛ m
ɔ b s t ɛ t r iː k a m	ɔ b s t ɛ t r iː k ɛ m
n a rː aː r ɛ	n a rː aː r ɛ
f l a k ʊ m	f l a kː ʊ m
s t ɔ r aː k ɛ	s t y r a k ɛ m
t j ɪ p ɛ ɪ d ʊ m	t ɛ p ɪ d ʊ m
s uː p iː n ʊ m	s ʊ p iː n ʊ m
g a s t aː r ɛ	w a s t aː r ɛ
f ʊ l ɛ k a m	f ʊ l ɪ k a m
w ʊ m l t aː r ɛ	w ɔ l uː t aː r ɛ
iː m m iː n ɛ n t ɛ	ɪ mː ɪ n eː r ɛ
m aː s a m	m a sː a m
ɛ ? a m r ɛ	kʷ ɪ eː t aː r ɛ
g a w ɛ t a m	g a b a t a m
k ɔ r n j ɛ ʊ m	k ɔ r n ɛu m
s aː t iː s f a k t j oː n ɛ m	s a t ɪ s f a k t j oː n ɛ m
s t a t ɛ r a m	s t a t eː r a m
k a p ɛ ɛ m	k a p ɪ t j ʊ m
t aʊ r iː f ɔ r m ɛ	t aʊ r ɪ f oː r m ɛ m
aː lː ɔ ŋ g aː r ɛ	eː l ɔ ŋ g aː r ɛ
f ʊ n d a m ɛ n t ʊ m	f ʊ n d aː m ɛ n t ʊ m
k uː r w aː r ɛ	k ʊ r w aː r ɛ
g l uː t ɪ n ɛ	g l uː t ɛ n
p r ɔ r ɔ g aː r ɛ	p r oː r ɔ g aː r ɛ
w a kʷ aː r ɛ	w a k aː r ɛ
k ɔ n d ɪ n a m t j ʊ m n ɛ m	k ɔ n d ɛ m n aː t j oː n ɛ m
k a w a l j ɛ	k a b a lː aː r j ʊ m
? k ɛ t aː r	oː s k ɪ t aː r ɛ
s p iː n a l ɛ	s p iː n aː l ɛ m
k ɔ n t ɛ n t j oː s ʊ m	k ɔ n t ɛ n t j oː s ʊ m
d eː s s p ɛ r aː t ʊ m	d eː s p eː r aː t ʊ m
iː n w ɛ r t iː r ɛ	ɪ n w ɛ r t ɛ r ɛ
w a g aː r ɛ	w a g aː r iː
m a l t a m	m a l tʰ a m
p r ɔ b l ɛ m aː t iː k ʊ m	p r ɔ b l eː m a t ɪ k ʊ m
ɛ k s p uː ŋ n aː r ɛ	ɛ k s p ʊ ŋ n aː r ɛ
p j ɛ r s ɪ k a m	p ɛ r s ɪ k a m
k r a m t ɪ k ʊ l a m	k r aː t ɪ k ʊ l a m
m ɔ d ɛ r	m ɔ l ɛ r ɛ
t r a m s m iː g r a m r ɛ	t r aː n s m ɪ g r aː r ɛ
s iː l iː k j ʊ m	s ɪ l ɪ k j ʊ m
w a m k j ɪ ʊ m	w a k iː w ʊ m
k a m p ɛ s t r ɛ	k a m p ɛ s t r ɛ m
k a m p ɛ r ɛ	k a p ɛ r ɛ
p a l uː s t r ɛ	p a l uː s t r ɛ m
f a r iː n oː s ʊ m	f a r iː n oː s ʊ m
a b ɔ l iː t j ʊ m n ɛ m	a b ɔ l ɪ t j oː n ɛ m
p r ɔ f uː g ʊ m	p r ɔ f ʊ g ʊ m
a r b uː s t iː w ʊ m	a r b ʊ s t iː w ʊ m
ɔ r t ɔ g r a f j ɛ	ɔ r tʰ ɔ g r a pʰ j a m
g r aː d ʊ m	g r a d ʊ m
ɔ r j ɪ ɛ n t a l ɛ	ɔ r ɪ ɛ n t aː l ɛ m
d ɔ l ɔ r oː s ʊ m	d ɔ l oː r oː s ʊ m
a m s p ʊ m r t a m r ɛ	a s p ɔ r t aː r ɛ
uː s t ɔ lː aː r ɛ	ʊ s t ʊ l aː r ɛ
n a t iː w iː t aː t ɛ m	n aː t iː w ɪ t aː t ɛ m
d ɛ g uː s t aː r ɛ	d eː g ʊ s t aː r ɛ
a d uː l t ɛ r aː r ɛ	a d ʊ l t ɛ r aː r ɛ
r ɛ k ɛ p t aː r ɛ	r ɛ k ɛ p t aː r ɛ
f r a m k s iː n ɛ ʊ m	f r a k s ɪ n ɛu m
p uː b ɛ	p uː b ɛ r ɛ m
n ʊ m t ɔ r j ʊ m	n oː t oː r j ʊ m
k ɔ n s uː m ɛ r ɛ	k oː n s uː m ɛ r ɛ
p l aː g j ʊ m	p l a g j ʊ m
iː ŋ n a r ʊ m	ɪ ŋ n aː r ʊ m
k ɔ n s ʊ p t j ʊ m n ɛ m	k oː n s uː m p t j oː n ɛ m
iː m p ɔ r t uː n iː t aː t ɛ m	ɪ m p ɔ r t uː n ɪ t aː t ɛ m
p iː k t oː r ɛ	p ɪ k t oː r ɛ m
g l aː d j ʊ m m	g l a d j ʊ m
g l ɔ s a m	g l ɔ sː a m
a s ɛ r t j ɔ n	a sː ɛ r t j oː n ɛ m
ɛ k s p uː r g a t j oː n ɛ m	ɛ k s p ʊ r g aː t j oː n ɛ m
r ɔ g aː r ɛ	r ɔ g aː r ɛ
s uː b j ɛ l a m	s uː b ʊ l a m
k ɔ n w ɛ n j ɛ n t j a m	k ɔ n w ɛ n ɪ ɛ n t j a m
d ɔ k t oː r ɛ	d ɔ k t oː r ɛ m
iː n k ɔ l uː m ɛ	ɪ ŋ k ɔ l ʊ m ɛ m
a b ɛ rː aː r ɛ	a b ɛ rː aː r ɛ
d eː w ɔ r a t j ʊ m n ɛ m	d eː w ɔ r aː t j oː n ɛ m
n ɔ n a m	n ɔ nː a m
a m s t uː t ʊ m	a s t uː t ʊ m
p r ɛ d ɔ m iː n aː r ɛ	p r aɪ d ɔ m ɪ n aː r iː
s uː b s ɛ kʷ iː r ɛ	s ʊ b s ɛ kʷ iː
k ɔ n t r ɔ w ɛ r s j a m	k ɔ n t r oː w ɛ r s j a m
p uː n iː r ɛ	p uː n iː r ɛ
aː ɪ k j aː k ʊ m	aɪ g y p t j a k ʊ m
k ɔ m m ɛ m ɔ r a t j ʊ m n ɛ m	k ɔ mː ɛ m ɔ r aː t j oː n ɛ m
r a d j a t j oː n ɛ	r a d j aː t j oː n ɛ m
k r uː ɛ n t aː r ɛ	k r ʊ ɛ n t aː r ɛ
p ɔ m iː f ɛ r ʊ m	p oː m ɪ f ɛ r ʊ m
t a k s a t j ʊ m n ɛ m	t a k s aː t j oː n ɛ m
kʷ ɔ t iː d j aː n ʊ m	kʷ ɔ t iː d j aː n ʊ m
uː d aː	uː d ʊ m
a m t ʊ n t ʊ m	a d j ʊ ŋ k t ʊ m
s uː m ɛ r ɛ	s uː m ɛ r ɛ
d ɛ p ɔ r t aː r ɛ	d eː p ɔ r t aː r ɛ
aʊ r ɔ r a	aʊ r oː r a m
p r ɛ g ʊ d iː k j ʊ m	p r aɪ j uː d ɪ k j ʊ m
l iː m iː t r ɔ f ɪ	l iː m ɪ t r ɔ pʰ ʊ m
t a m t ʊ f ɛ ʊ ʊ m	t uː b ɛ r
r ɛ s p ɔ n s ʊ m	r ɛ s p oː n s ʊ m
ɔ b l iː t ɛ r aː r ɛ	ɔ b l ɪ tː ɛ r aː r ɛ
r ɔ t a m r ɛ	r ʊ k t aː r ɛ
b a r b a r iː s m ʊ m	b a r b a r ɪ s m ʊ m
t r aː k j ʊ m	tʰ r aː k j ʊ m
r iː s ɪ d ɛ r ɛ	r ɛ s ɪ d eː r ɛ
aʊ s p iː t j ʊ m	aʊ s p ɪ k j ʊ m
b r aː k ɛ m	b r aː k aː s
f a k ʊ n d j a m	f aː k ʊ n d j a m
d oː n ɛ m s t aː r	d ɛ h ɔ n ɛ s t aː r ɛ
a d ɔ r m iː r ɛ	a dː ɔ r m iː r ɛ
m ɛ r ɛ t r iː k j ʊ m	m ɛ r ɛ t r iː k j ʊ m
r ɔ ɪ b j a m	r ʊ b j a m
ʊ m l ɛ aː t ʊ m	ɔ l ɛ aː t ʊ m
k ɔ nː ʊ m	k ʊ nː ʊ m
aː k t ʊ m	aː k t ʊ m
rː ɛ t oː r	r h eː t ɔ r ɛ m
r uː k j ʊ m	r oː s k ɪ d ʊ m
s a k r a m ɛ n t a l ɛ	s a k r aː m ɛ n t aː l ɛ m
n ɛ g aː r ɛ	n ɛ g aː r ɛ
rː ɛ m uː n ɛ r aː r	r ɛ m uː n ɛ r aː r ɛ
ɪ s k ʊ m	ɪ s k ʊ m
w ɛ n d ɛ m j a m	w iː n d eː m j a m
iː n t ɛ iː ɛ	ɪ n t ʊ eː r iː
ɔ rː ɛ n d ʊ m	h ɔ rː ɛ n d ʊ m
k a l a m ʊ m m	k a l a m ʊ m
m uː k ɔ ɛ r ɛ	m uː k oː r ɛ m
uː m uː s	h ʊ m ʊ m
r ɛ f l uː ɪ r ɛ	r ɛ f l ʊ ɛ r ɛ
p ɛ lː iː k ʊ l a m	p ɛ lː ɪ k ʊ l a m
f ɛ ɛ b ʊ m l ɛ	f l eː b ɪ l ɛ m
t ɛ k l a m	tʰ eː k a m
l iː n k ɛ	l y ŋ k ɛ m
b a l b ʊ t ɛ r ɛ	b a l b uː t iː r ɛ
iː n ɛ b r j a m r ɛ	ɪ n eː b r j aː r ɛ
a b d ɔ m ɛ n	a b d oː m ɛ n
p r ɔ n ɔ s t iː k	p r ɔ ŋ n oː s ɛ m
d ɪ s t iː lː aː r ɛ	d eː s t ɪ lː aː r ɛ
k ɔ l ɛ f a m k ɛ r	k a l ɛ f a k ɛ r ɛ
t r a m d ɛ r ɛ	t r aː d ɛ r ɛ
f h ɛ rː aː r ʊ m	f ɛ rː aː r j ʊ m
d ɛ s t r uː k t j ʊ m n ɛ m	d eː s t r ʊ k t j oː n ɛ m
a k r ɪ t ɛ t ɛ	aː k r ɪ t aː t ɛ m
k r iː t ɛ r j ʊ m	k r ɪ t ɛ r ɪ ɔ n
a d j uː d iː k a t j ʊ m n ɛ m	a d ɪ uː d ɪ k aː t j oː n ɛ m
d aː t a m	d a t a
a b s t r uː s ʊ	a b s t r uː s ʊ m
k r ɛ d iː b ɪ l ɛ	k r eː d ɪ b ɪ l ɛ m
b j ɛ t eː ɛ b a	b eː t a m
p ɛ t ʊ m	p eː d ɪ t ʊ m
ɔ s aː r ɛ	aʊ d eː r ɛ
ɛ g s ɛ r k ɛ r ɛ	ɛ k s ɛ r k eː r ɛ
f ɪ b uː l a m	f iː b ʊ l a m
iː m mː ɔ l a t j ʊ m n ɛ m	ɪ mː ɔ l aː t j oː n ɛ m
ɛ k s p uː l s aː r	ɛ k s p ʊ l s aː r ɛ
t r a m s p ɔ r ɛ m	t r aː n s p oː n ɛ r ɛ
a m n ɛ g aː r	eː n ɛ k aː r ɛ
a k t oː r ɛ	aː k t oː r ɛ m
l iː n aː r ʊ m	l iː n aː r j ʊ m
d ɪ s t ɛ ŋ d ɪ n ɛ m ɛ r ɛ	d eː s k ɛ n d ɛ r ɛ
t ɛ n s uː r a m	k eː n s uː r a m
t r a m l uː k ɪ r ɛ	t r aː n s l uː k eː r ɛ
s a n t ʊ m r j ɛ t a m	s a t ʊ r eː j a m
s ɔ l aː r ɪ j ʊ m	s oː l aː r j ʊ m
p r ɛ t ɛ r n a t uː r a l ɛ	p r aɪ t ɛ r n aː t uː r aː l ɛ m
ɛ s t w ʊ m	aɪ s t aː t ɛ m
s a p oː r ɛ	s a p oː r ɛ m
a m l j ɛ n t ʊ m	a n h eː l ɪ t ʊ m
g uː b iː l aː r ɛ	j uː b ɪ l aː r ɛ
k ɔ n s ɪ l ʊ m	k ɔ ŋ k ɪ l j ʊ m
r ɔ k ʊ m	r aʊ k ʊ m
k a t ɛ k iː s m ʊ m	k a t eː kʰ ɪ s m ʊ m
p r ɛ n ɪ	p r aɪ ŋ n aː t ɛ m
d ɛ s iː n ɛ n t a m	d eː s ɪ n ɛ n t j a m
w ɛ r n ɪ k ɛ	w ɛ r n iː k ɛ m
g a m lː ɛ g ʊ m	g a lː aɪ k ʊ m
m ɔ l ɛ k ʊ l a m	m oː l ɛ k ʊ l a m
ɛ f iː k a k ɛ	ɛ fː ɪ k aː k ɛ m
k ɔ ŋ n ɔ m ɛ m	k oː ŋ n oː m ɛ n
ɛ n a m rː a m t j ʊ m n ɛ m	eː n aː rː aː t j oː n ɛ m
p uː s t ʊ l a m	p ʊ s t ʊ l a m
a m b ɔ m aː s ʊ m	a b ɔ m aː s ʊ m
p r ɛ p ɔ r ɛ m	p r aɪ p oː n ɛ r ɛ
d ɛ s p ɛ n s a m r ɛ	d ɪ s p eː n s aː r ɛ
d ɛ n uː d aː r ɛ	d eː n uː d aː r ɛ
kʷ aː r t ʊ m	kʷ aː r t ʊ m
t a m l ʊ t ɛ m	t aː l ʊ m
s j ɛ h n t iː f iː k ʊ m	s k ɪ ɛ n t ɪ f ɪ k ʊ m
ɔ p r iː m ɛ r	ɔ pː r ɪ m ɛ r ɛ
l iː r iː k ʊ m	l y r ɪ k ʊ m
aː s	a sː ɛ m
a lː ɛ g r ɪ	a l a k r ɛ m
a l t ɛ r k a t j ʊ m n ɛ m	a l t ɛ r k aː t j oː n ɛ m
s t r ɔ p ʊ m	s t r ɔ pː ʊ m
m iː l j a r j ʊ m	m iː lː j aː r j ʊ m
ʊ s t r ʊ	aʊ s t r ʊ m
p aʊ s a m	p aʊ s a m
a k a n t ʊ m	a k a n tʰ ʊ m
g uː d iː t j aː l ɛ	j uː d ɪ k j aː l ɛ m
w iː s aː r ɛ	w iː s ɛ r ɛ
p r ɔ m ɛ t ɛ r ɛ	p r oː m ɪ tː ɛ r ɛ
ʊ r t iː k aː r j a m	ʊ r t iː k aː r j a m
r iː g ʊ r ɔ s ʊ m	r ɪ g ɔ r ɔ s ʊ m
s ʊ w ɛ n iː r ɛ	s ʊ b w ɛ n iː r ɛ
d ɔ ɛ ʊ m	d ɔ l ʊ m
n ɛ s k j ʊ m	n ɛ s k j ʊ m
n ɔ nː ʊ m	n ɔ nː ʊ m
k aː r ʊ m	k aː r ʊ m
ɛ n ɛ ʊ m	a eː n ɛu m
k ɛ l iː b eː	k aɪ l ɪ b ɛ m
w ɛ n ɛ r a t j ʊ m n ɛ m	w ɛ n ɛ r aː t j oː n ɛ m
w a g a b ʊ n d ʊ m	w a g aː b ʊ n d ʊ m
l a m m b ɛ r ɛ	l a m b ɛ r ɛ
f aː r t ʊ m	f a r t ʊ m
ɛ k s t ɛ r j ɔ r	ɛ k s t ɛ r j oː r ɛ m
k aː r m ɛ m	k a r m ɛ n
p uː n iː t j oː n ɛ m	p uː n iː t j oː n ɛ m
n aʊ f r a g aː r ɛ	n aʊ f r a g aː r ɛ
s ɔ l aː r ɛ	s oː l aː r ɛ m
p ɛ r t ɪ k a m	p ɛ r t ɪ k a m
d a m ʊ nː oː s ʊ m	d a m n oː s ʊ m
k ɔ n d iː t j oː n ɛ	k ɔ n d ɪ k j oː n ɛ m
f aː rː ʊ m	f a rː ɛu m
k ʊ m r uː s k a m r ɛ	k ɔ r ʊ s k aː r ɛ
p ɔ w oː r a	p a w oː r ɛ m
a m k ɛ r b iː t eː t ɛ m	a k ɛ r b ɪ t aː t ɛ m
ɛ r ɛ d ɪ m aː t ɛ m	h eː r eː d ɪ t aː t ɛ m
a ɛ r ɔ m a n t j a m	aː ɛ r ɔ m a n t iː a m
ʊ n d aː r ɛ	ʊ n d aː r ɛ
d iː w uː l g a t j ʊ m n ɛ m	d iː w ʊ l g aː t j oː n ɛ m
p r ɔ iː b iː t j ɔ n	p r ɔ h ɪ b ɪ t j oː n ɛ m
r ɛ w ɛ r s ɛ r ɛ	r ɛ w ɛ r t iː
g ɔ s t ʊ m	g ʊ s t ʊ m
b aː j ɛ l eː	b aː j ʊ l ʊ m
ɛ k s p iː r a t j ʊ m n ɛ m	ɛ k sː p iː r aː t j oː n ɛ m
b l a m n d iː t j a m	b l a n d ɪ t j a m
b a m r b aː t ʊ m	b a r b aː t ʊ m
p ɛ r f iː d ʊ m	p ɛ r f ɪ d ʊ m
k r uː ɛ l d a l t ɛ m	k r uː d eː l ɪ t aː t ɛ m
k iː r k uː m n a w ɪ g aː r ɛ	k ɪ r k ʊ m n aː w ɪ g aː r ɛ
ɪ r ɔ ɛ r ɛ	ɛ rː oː r ɛ m
p a lː oː r ɛ	p a lː oː r ɛ m
ɔ l a m	ɔ lː a m
m iː l aː j ʊ m	m iː lː j aː r j ʊ m
m ɛ s uː r aː r ɛ	m eː n s uː r aː r ɛ
p r ɔ p r ɪ j ɛ t aː t ɛ m	p r oː p r ɪ ɛ t aː t ɛ m
k ɔ n d ɔ l eː r ɪ	k ɔ n d ɔ l eː r ɛ
ʊ m s h ɛ m	uː ŋ k t j oː n ɛ m
n aː s ʊ m	n aː s ʊ m
n w ɔ t aː r ɛ	n a t aː r ɛ
l ɛ w iː g a m r ɛ	l ɛ w ɪ g aː r ɛ
p r ɛ ɔ k uː p aː r ɛ	p r aɪ ɔ kː ʊ p aː r ɛ
r ɛ m ɛ ɛ r	r ɛ m ɪ s k eː r ɛ
n aʊ s ɪ b ʊ n d ʊ m	n aʊ s ɛ aː b ʊ n d ʊ m
d iː f ɛ r ɪ r ɛ	d ɪ fː ɛ rː ɛ
s p ɛ k iː f iː k ʊ m	s p ɛ k ɪ f ɪ k ʊ m
p ɛ r iː t ʊ m	p ɛ r iː t ʊ m
d ɪ s p ɛ r aː r ɛ	d eː s p eː r aː r ɛ
r ɪ s ʊ m	r iː s ʊ m
r ɛ d ɛ m m t j oː n ɛ	r ɛ d ɛ m p t j oː n ɛ m
k ɔ r ɔ n ɪ ɪ	k ɔ r oː n ɪ d ɛ m
f l uː ɪ r ɛ	f l ʊ ɛ r ɛ
p a l ʊ m b aː r ʊ m	p a l ʊ m b aː r j ʊ m
k ɔ n d uː k t j oː n ɛ m	k ɔ n d ʊ k t j oː n ɛ m
w iː lː a n ʊ m	w iː lː aː n ʊ m
n ɛ g r ɪ t a m	n ɪ g r ɪ t j a m
m a s k ʊ l iː n ʊ m	m a s k ʊ l iː n ʊ m
b ɛ lː ʊ m	b ɛ lː ʊ m
r uː ɛ r	r ʊ ɛ r ɛ
k ɛ r k aː r ɛ	k ɪ r k aː r ɛ
w ɛ k a m	w ɪ k j a m
f ɔ r aː r ɛ	f ɔ r aː r ɛ
t aː b ʊ l a m	t a b l a m
s t uː d j aː r ɛ	s t ʊ d eː r ɛ
s p uː t ʊ m	s p uː t ʊ m
k eː kʷ ʊ m	k aɪ k ʊ m
m ɛ n d iː k ʊ m	m ɛ n d iː k ʊ m
rː ɛ t iː n a k ʊ l ʊ m	r ɛ t ɪ n aː k ʊ l ʊ m
w ɪ t ɪ m aː r ɛ	w ɪ k t ɪ m aː r ɛ
r ɛ g ʊ l a r iː t aː t ɛ m	r eː g ʊ l aː r ɪ t aː t ɛ m
d eː m a n d aː r ɛ	d eː m a n d aː r ɛ
f r ɛ m ɪ t ʊ m	f r ɛ m ɪ t ʊ m
m a l f aː t oː r ɛ	m a l ɛ f a k t oː r ɛ m
s a ŋ gʷ iː n aː r j ʊ m	s a ŋ gʷ ɪ n aː r j ʊ m
f ɛ s t iː n a m r ɛ	f ɛ s t iː n aː r ɛ
p uː d oː r ɛ	p ʊ d oː r ɛ m
s ɛ k aː l ɛ	s ɛ k aː l ɛ
w a r ɛ r	w ɛ rː ɛ r ɛ
a s ɪ ŋ n aː r ɛ	a sː ɪ ŋ n aː r ɛ
p l ʊ m b a j iː n ɛ	p l ʊ m b aː g ɪ n ɛ m
iː m p ɛ r t ɛ p t iː b l ɛ	ɪ m p ɛ r k ɛ p t ɪ b ɪ l ɛ m
l uː p iː n ʊ m	l ʊ p iː n ʊ m
s kʷ aː m a m	s kʷ aː m a m
t ɪ t iː d aː t ɛ m	a k ɪ d ɪ t aː t ɛ m
k ɔ n d uː k ɪ r ɛ	k ɔ n d uː k ɛ r ɛ
a k ʊ m	a k ʊ m
p r ɔ n ʊ m	p r oː n ʊ m
m aː n s j ʊ m n ɛ m	m aː n s j oː n ɛ m
n a m n ʊ m	n aː n ʊ m
b ɛ n ɛ d ɪ k ɛ r ɛ	b ɛ n ɛ d iː k ɛ r ɛ
t oː r ɛ	t oː r ɛ m
iː m p r ɔ b iː t aː	ɪ m p r ɔ b ɪ t aː t ɛ m
k ɔ r t ɛ	k oː r t ɛ m
g ɛ m iː n aː r ɛ	g ɛ m ɪ n aː r ɛ
d ɔ m aː r ɛ	d ɔ m aː r ɛ
f ɔ r t iː t uː d ɪ n ɛ	f ɔ r t ɪ t uː d ɪ n ɛ m
l a k ɛ r aː r ɛ	l a k ɛ r aː r ɛ
w ɛ r t ɛ r ɛ	w ɛ r t ɛ r ɛ
a k uː m uː l a t j ʊ m n ɛ m	a kː ʊ m ʊ l aː t j oː n ɛ m
s p uː t aː r ɛ	s p uː t aː r ɛ
k ɔ n f ɛ r ɛ r ɛ	k oː n f ɛ rː ɛ
w ɛ d ʊ w a m	w ɪ d w a m
a s p ɛ k t ʊ m	a s p ɛ k t ʊ m
k ɔ n k ɛ d ɛ r ɛ	k ɔ ŋ k eː d ɛ r ɛ
a m p ɔ lː a m	a m p ʊ lː a m
f ɛ n eː s t r a m	f ɛ n ɛ s t r a m
m ɪ ɛ	m eː n s ɛ m
m aː r t ɛ r ɛ	m a r t y r ɛ m
k ɔ r j aː k ɛ ʊ m	k ɔ r j a k ɛu m
