d ʊ ɛ k j ɛ n t ʊ m s	d ʊ k ɛ n t oː s
f ʊ l k a m	f ʊ l ɪ k a m
f ɛ s aː r ɛ	f a t eː r iː
p ɪ s k ʊ m p aː d ʊ m	ɛ p ɪ s k ɔ p aː t ʊ m
k ɛ n s oː r ɛ	k eː n s oː r ɛ m
ʊ m f ɛ r t oː r j ʊ m	ɔ fː ɛ r t oː r j ʊ m
s ʊ b s iː d j ʊ m	s ʊ b s ɪ d j ʊ m
f a j a l ɛ	f a k j aː l ɛ m
p r ɛ t iː p iː t j ʊ m	p r aɪ k ɪ p ɪ t j ʊ m
s ɛ n s w ʊ a l iː t aː t ɛ m	s ɛ n s w aː l ɪ t aː t ɛ m
ɛ k s t ɛ r m iː n a t j oː n	ɛ k s t ɛ r m ɪ n aː t j oː n ɛ m
r ɛ l ɛ g a t j oː n ɛ m	r ɛ l eː g aː t j oː n ɛ m
s ʊ b iː r ɛ	s ʊ b iː r ɛ
ɔ b t ɛ n ɛ r ɛ	ɔ b t ɪ n eː r ɛ
ɔ kʷ r	a w ʊ ŋ k ʊ l ʊ m
g a l ɛ n a m	g a l eː n a m
s a p oː n ɛ	s aː p oː n ɛ m
m ʊ s t ʊ m	m ʊ s t ʊ m
n ɔ k ɛ t ʊ m	n ʊ k eː t ʊ m
k a l k aː r ʊ m	k a l k aː r j ʊ m
t ɔ r w ʊ m	t ɔ r w ʊ m
w ɛ r s iː k ʊ l ʊ m	w ɛ r s ɪ k ʊ l ʊ m
d ɛ l iː n kʷ ɛ r ɛ	d eː l ɪ ŋ kʷ ɛ r ɛ
ɛ s k r ʊ t aː r	s k r uː t aː r iː
n ɔ t a m	n ɔ t a m
g ɛ n t iː l iː t a m	g ɛ n t iː l ɪ t aː t ɛ m
ɛ m ɛ t ɛ r ɛ	eː m ɪ tː ɛ r ɛ
s ɛ p t ɛ n t r j ɔ n a l ɛ	s ɛ p t ɛ n t r j oː n aː l ɛ m
k ɔ m p l a m k ɛ r ɛ	k ɔ m p l a k eː r ɛ
b ɛ r ɛ b ɪ k ɛ	w ɛ r w eː k s
iː n kʷ j ɛ t ʊ d ɪ n ɛ m	ɪ ŋ kʷ ɪ eː t uː d ɪ n ɛ m
s a b l ʊ m ɛ	s a b ʊ l oː n ɛ m
h ɛ m s ɪ r ʊ	ɛ k s iː r ɛ
a m s ɔ l aː r	a sː ɔ l aː r ɛ
iː m p ɔ s iː t j oː n ɛ m	ɪ m p ɔ s ɪ t j oː n ɛ m
k ʊ r a m t ʊ r a m	k uː r aː t uː r a m
a r k aː n ʊ m	a r k a n ʊ m
t j ɛ p ɛ ɪ d ʊ m	t ɛ p ɪ d ʊ m
aː k uː l ɛ t j ʊ m	a k ʊ l ɛu m
s ʊ m iː t a t ɛ m	s ʊ mː ɪ t aː t ɛ m
f ʊ ŋ g oː s ʊ m	f ʊ ŋ g oː s ʊ m
k ʊ p ɛ r t ʊ r a m	k ɔː p ɛ r t uː r a m
k iː s t ɛ r n a m	k ɪ s t ɛ r n a m
f ʊ l w ʊ m	f ʊ l w ʊ m
m ɛ s t ʊ m	m aɪ s t ʊ m
k ʊ n k iː t a m t j oː n ɛ m	k ɔ ŋ k ɪ t aː t j oː n ɛ m
p ɛ s aː r ɛ	p eː n s aː r ɛ
k ɔ n t r a dː iː k t oː r ɛ	k ɔ n t r aː d ɪ k t oː r ɛ m
s t a t ʊ ɛ r ɛ	s t a t ʊ ɛ r ɛ
ɪ n f ɛ r m ʊ m	iː n f ɪ r m ʊ m
b ɛ n ɛ f iː k j ʊ m	b ɛ n ɛ f ɪ k j ʊ m
s ɛ n ɛ	s ɛ n ɛ m
r ɛ p ɛ r k ʊ s j oː n ɛ m	r ɛ p ɛ r k ʊ t ɛ r ɛ
p a s t a m	p a s t a m
l iː m aː r ɛ	l iː m aː r ɛ
f a m s iː n j ʊ m	f a s k ɪ n ʊ m
t ɛ g ʊ r a m	t oː n s oː r j ʊ m
ɔ r iː f iː k ʊ m	h ɔ rː ɪ f ɪ k ʊ m
iː m p ɛ t iː g ɪ k ɛ m	ɪ m p ɛ t iː g ɪ n ɛ m
ɪ n t ɛ r p ʊ n g ɛ r ɛ	ɪ n t ɛ r p ʊ ŋ g ɛ r ɛ
s ɛ s kʷ iː p ɛ d a m l ɛ	s eː s kʷ ɪ p ɛ d aː l ɛ m
ɛ k s a m iː n aː r ɛ	ɛ k s aː m ɪ n aː r ɛ
p l a m n iː k j ɛ	p l aː n ɪ t ɪ ɛ m
k ɛ lː a m	k ɛ lː a m
t ɛ r m ɪ t ɛ	t a r m ɪ t ɛ m
s k ʊ p aː r ɛ	s k ɔ p ɛ r ɛ
r ɛ p r ɛ ɛ n s j oː n ɛ m	r ɛ p r ɛ h ɛ n s j oː n ɛ m
k ɔ n s iː s t ɛ r ɛ	k oː n s ɪ s t ɛ r ɛ
p ɛ t aː t ʊ m	p ɪ tː a k j ʊ m
k ʊ m p r a m t ɔ r ɛ	k ɔ m p a r aː t oː r ɛ m
k ɔ ɛ r t uː m j ɔ n	k ɔ ɪ r k ɪ t j oː n ɛ m
t r iː n ɪ t aː t ɛ m	t r iː n ɪ t aː t ɛ m
a m n iː m ʊ m	a n ɪ m ʊ m
iː m mː ɔ l a t j oː n ɛ m	ɪ mː ɔ l aː t j oː n ɛ m
a m k ɛ b ɪ l ɛ ʊ m	a kʷ ɪ f ɔ l j ʊ m
p a lː j ʊ r ʊ m	p a l ɪ uː r ʊ m
k ɔ l oː n j aː m	k ɔ l oː n j a m
iː m w ɛ t ɛ r aː r	ɪ n w ɛ t ɛ r aː r ɛ
ɛ s kʷ a l iː d ʊ m	s kʷ aː l ɪ d ʊ m
k ɔ n s ɔ r t ɛ	k oː n s ɔ r t ɛ m
s ɔ m ʊ m	s ɔ m n ʊ m
kʷ a t r aː t ʊ m	kʷ a d r aː t ʊ m
p r ɛ t ɛ n d ɛ r ɛ	p r aɪ t ɛ n d ɛ r ɛ
ɛ n s ɛ m	eː n s ɛ m
s t r ɔ ɛ n ɛ t ʊ m	t ɔ n ɪ t r ʊ m
w ɛ r ɪ t aː t ɛ m	w eː r ɪ t aː t ɛ m
f ɪ b ʊ l a m	f iː b ʊ l a m
m ʊ m s ʊ m	m ʊ s t ɛu m
a f ɪ r m aː r ɛ	a fː ɪ r m aː r ɛ
k ʊ r s ʊ m	k ʊ r s ʊ m
iː w ʊ m	iː w ʊ m
p ɛ k aː r ɛ	p ɛ kː aː r ɛ
t oː s oː n ɛ m	t oː n s j oː n ɛ m
r ɪ j ʊ m	r iː w ʊ m
ɛ k s iː k a t j ʊ m n ɛ m	ɛ k sː ɪ kː aː t j oː n ɛ m
m ɛ d iː t ɛ rː aː n ɛ ʊ m	m ɛ d ɪ t ɛ rː aː n ɛu m
a g r ɛ s t ɛ	a g r ɛ s t ɛ m
d ɛ p r ɛ d a t j ʊ m n ɛ m	d eː p r aɪ d aː t j oː n ɛ m
a n ɔ n a m	a nː oː n a m
iː lː ɛ g a l ɛ	ɪ lː eː g aː l ɛ m
t r a m s p ɔ r t aː r ɛ	t r aː n s p ɔ r t aː r ɛ
d r ɪ t ʊ r a m	d iː r ɛ k t uː r a m
n ʊ t aː r	n uː t aː r ɛ
d ɛ l iː b ɛ r aː r ɛ	d eː l iː b ɛ r aː r ɛ
m ɔ n d aː r	m ʊ n d aː r ɛ
m a m n ʊ m	m a ŋ n ʊ m
s ʊ m a m	s ʊ mː a m
aː n ʊ m	aː n ʊ m
iː n w iː k t ʊ m	ɪ n w ɪ k t ʊ m
m a n iː p ʊ l ʊ m	m a n ɪ p ʊ l ʊ m
ɔ r d iː n aː r j ʊ m	oː r d ɪ n aː r j ʊ m
s t ʊ p r ʊ m	s t ʊ p r ʊ m
d ʊ r aː k ɪ n ʊ m	d uː r a k ɪ n ʊ m
h ɛ r eː m ʊ m	ɛ r eː m ʊ m
iː t iː n ɛ r aː r j ʊ m	ɪ t ɪ n ɛ r aː r j ʊ m
ɔ b j ʊ m h	ɔ b w j ʊ m
aʊ d iː t j oː n ɛ	aʊ d iː t j oː n ɛ m
s k ɔ r j a m	s k oː r j a m
b ʊ t ɛ lː ʊ m	b ɔ t ɛ lː ʊ m
k ɔ ɔ k ʊ m	k ɔ kʷ ʊ m
p ɛ r k ʊ s ɔ r	p ɛ r k ʊ sː oː r ɛ m
f ʊ m r m a g ʊ m	f oː r m aː t ɪ k ʊ m
d iː s p a r ɪ r r ɛ	d ɪ s p a r eː r ɛ
ɔ r ɛ k ʊ j a m	ɔ r ɪ k l a m
s ɛ m d aː r ɛ r ɛ	s ɛ d eː r ɛ
f a w oː r ɛ	f a w oː r ɛ m
p ɛ r k ɔ l aː r ɛ	p ɛ r k oː l aː r ɛ
ɛ k s p ʊ ŋ g ɪ r ɛ	ɛ k s p ʊ ŋ g ɛ r ɛ
k r ɛ s p a m r ɛ	k r ɪ s p aː r ɛ
s ɛ g ɛ lː ʊ m	s ɪ g ɪ lː ʊ m
l a m k r iː m a m t j ʊ m n ɛ	l a k r ɪ m aː t j oː n ɛ m
ɛ s t r ɛ n a m	s t r eː n a m
r ɛ p r ʊ w aː r ɛ	r ɛ p r ɔ b aː r ɛ
n ɛ s iː	n ɛ s k iː r ɛ
a m b n ʊ iː r	a b n ʊ ɛ r ɛ
ɛ f iː k a k ɛ	ɛ fː ɪ k aː k ɛ m
p ɛ r t ʊ r b aː r ɛ	p ɛ r t ʊ r b aː r ɛ
k ɔ n f l iː k t ʊ m	k oː n f l ɪ k t ʊ m
k ɔ n s ʊ l t a t j oː n ɛ m	k oː n s ʊ l t aː t j oː n ɛ m
d j a b oː l iː k ʊ m	d j a b ɔ l ɪ k ʊ m
t ɛ n ɛ b r a m	t ɛ n ɛ b r a m
iː n ʊ m s ɛ r ɛ	ɪ ŋ n oː s k ɛ r ɛ
p ɔ m ɛ t ʊ m	p ɔ m eː t ʊ m
p a l ʊ d oː s ʊ m	p a l uː d oː s ʊ m
w ɛ d ʊ w a m	w ɪ d w a m
r ʊ t a m r ɛ	r ʊ k t aː r ɛ
w oː t ʊ m	w oː t ʊ m
s a p oː r ɛ	s a p oː r ɛ m
w iː w aː r j ʊ m	w iː w aː r j ʊ m
k a l iː f a	k a l iː pʰ a m
k l iː m a m t ɛ r iː k ʊ m	k l iː m a k t eː r ɪ k ʊ m
l a n oː s ʊ m	l aː n oː s ʊ m
a k ʊ m ʊ l a t j oː n ɛ m	a kː ʊ m ʊ l aː t j oː n ɛ m
p ɛ r g ʊ r j ʊ m	p ɛ r ɪ uː r j ʊ m
g ʊ r a m m ɛ n t ʊ m	j uː r aː m ɛ n t ʊ m
ɔ s k ʊ l a m t j oː n ɛ m	ɔ s k ʊ l aː t j oː n ɛ m
ɛ k s f ɔ l j aː r	ɛ k s f oː l j aː r ɛ
k a p s g oː k ʊ m	k a p t j oː s ʊ m
iː n k ɔ m p ɛ t ɛ n t ɛ m	ɪ ŋ k ɔ m p ɛ t ɛ n t ɛ m
s ɪ k s ɪ t aː t a	s ɪ kː ɪ t aː t ɛ m
k ʊ ŋ	ɛ kː ʊ m
ʊ r g ɛ r ɛ	ʊ r g eː r ɛ
k ʊ n t ɛ n d ɛ r ɛ	k ɔ n t ɛ n d ɛ r ɛ
j ʊ g ɛ r ʊ m	j uː g ɛ r ʊ m
k ɔ lː ɛ m	k ɔ lː ɛ m
iː n t r ɔ d ʊ k t j oː n ɛ m	ɪ n t r oː d ʊ k t j oː n ɛ m
d ɔ k t oː r ɛ	d ɔ k t oː r ɛ m
iː n w ɛ r t iː r ɛ	ɪ n w ɛ r t ɛ r ɛ
ʊ s ɪ n ɔ l ʊ m	l ʊ s k ɪ n j a m
s ʊ b ɔ r n aː r ɛ	s ʊ b oː r n aː r ɛ
a t r ʊ m	aː t r ʊ m
k a l a m iː t aː t ɛ m	k a l a m ɪ t aː t ɛ m
iː n ɛ k t j oː n ɛ m	ɪ n ɪ ɛ k t j oː n ɛ m
p r oː n ʊ m	p r oː n ʊ m
a m iː k iː t j a m	a m iː k ɪ t j a m
ɛ l iː m iː n aː r ɛ	eː l iː m ɪ n aː r ɛ
k ɔ n k ɛ d ɛ r ɛ	k ɔ ŋ k eː d ɛ r ɛ
t ʊ m s ʊ m	t oː n s ʊ m
ɔ t r ɛ	ʊ t r ʊ m
s a l ɪ k ɛ t ʊ m	s a l ɪ k eː t ʊ m
g ɪ n j ɪ p eː r ʊ m	j uː n ɪ p ɛ r ʊ m
r ɛ m ɛ m b r a r ɛ	r ɛ m ɛ m ɔ r aː r iː
s ɛ m ɛ m	s eː m ɛ n
s p ɛ k t aː k ʊ l ʊ m	s p ɛ k t aː k ʊ l ʊ m
s ʊ b s t a n t a m	s ʊ b s t a n t j a m
p ɛ lː iː k ʊ l a m	p ɛ lː ɪ k ʊ l a m
s iː t j ʊ m	s ɪ t ʊ m
k ɛ r oː s ʊ m	k eː r oː s ʊ m
ɛ l ʊ ɛ r	eː l ʊ ɛ r ɛ
aː k t ʊ m	aː k t ʊ m
a t k ɛ r ʊ m iː r ɛ	a kː w iː r ɛ r ɛ
s t ɔ l iː d ʊ m	s t ɔ l ɪ d ʊ m
f ɔ r m a m	f oː r m a m
r ɛ w ɛ r b ɛ r aː r	r ɛ w ɛ r b ɛ r aː r ɛ
d ɛ f l ʊ iː r ɛ	d eː f l ʊ ɛ r ɛ
b a k t ɪ s ɪ m ʊ m	b a p t ɪ s m ʊ m
k a r ɛ n a m	k a r iː n a m
d ʊ k ɪ r ɛ	d uː k ɛ r ɛ
m a n a j ɛ r ʊ m	m a n w aː r j ʊ m
s ʊ s t ɛ n t aː k ʊ l ʊ m	s ʊ s t ɛ n t aː k ʊ l ʊ m
a w ɛ n iː r ɛ	a d w ɛ n iː r ɛ
m ɔ t j oː n ɛ m	m oː t j oː n ɛ m
t ʊ r b a m	t ʊ r b a m
g lː aː n d ʊ lː oː s ʊ m	g l a n d ʊ l oː s ʊ m
k ɔ n t r a w ɛ n iː r	k ɔ n t r aː w ɛ n iː r ɛ
w ɛ l ɔ k ɛ	w eː l oː k ɛ m
k ɔ ŋ j ʊ g a t j oː n ɛ m	k ɔ n j ʊ g aː t j oː n ɛ m
p r ɔ m ɛ s a m	p r oː m ɪ sː ʊ m
ɪ n k eː n d ɛ m r ɛ	ɪ ŋ k ɛ n d ɛ r ɛ
k r iː m ɪ n ɛ	k r iː m ɛ n
s ɛ l w aː t iː k ʊ m	s ɪ l w aː t ɪ k ʊ m
s a l a t iː t aː t ɛ	s a l aː k ɪ t aː t ɛ m
r a d j a t j oː n ɛ	r a d j aː t j oː n ɛ m
a t ɛ n d ɛ r ɛ	a tː ɛ n d ɛ r ɛ
p ɔ r k a	p ɔ r k a m
m a s k l ʊ m l	m a s k ʊ l ʊ m
k ɔ m s t r iː k t oː r ɛ	k oː n s t r ɪ k t oː r ɛ m
t a b l a m	t a b ʊ l a m
ɛ k s t ɛ n s iː w ʊ m	ɛ k s t eː n s iː w ʊ m
n ɛ f aː r j ʊ m	n ɛ f aː r j ʊ m
b iː k a m	b iː g a m
k r ɔ n iː k ʊ m	kʰ r ɔ n ɪ k ʊ m
a b s ɔ l ʊ t j oː n ɛ m	a b s ɔ l uː t j oː n ɛ m
p ɛ r k a m	p ɛ r k a m
l ʊ n ʊ l a m	l uː n ʊ l a m
a d m ɔ n iː t j oː n ɛ m	a d m ɔ n ɪ t j oː n ɛ m
p ʊ b l iː k ʊ m	p uː b l ɪ k ʊ m
ɛ w ɔ l ʊ k w ɛ r ɛ	eː w ɔ l w ɛ r ɛ
ʊ ŋ t oː ɛ m s ʊ m	uː ŋ k t ʊ oː s ʊ m
k ɛ r t a m m ɛ m	k ɛ r t aː m ɛ n
a g aː r iː k ʊ m	a g a r ɪ k ʊ m
p r ɔ d iː g j ʊ m m j ʊ m	p r oː d ɪ g j oː s ʊ m
iː ŋ n ɛ ʊ m	ɪ ŋ n ɛu m
p ɛ r s ɛ k ɪ r ɛ	p ɛ r s ɛ kʷ iː
iː m s t iː t ʊ ɪ r ɛ	iː n s t ɪ t ʊ ɛ r ɛ
p ɛ r s w a d ɛ r ɛ	p ɛ r s w aː d eː r ɛ
p ʊ ɛ r iː l ɪ t aː t ɛ m	p ʊ ɛ r iː l ɪ t a t ɛ m
iː n k ɔ l a m	ɪ ŋ k ɔ l a m
s j ɛ p ɛ	s aɪ p ɛ m
t ɛ r g iː w ɛ r s aː r ɛ	t ɛ r g ɪ w ɛ r s aː r iː
d ɛ s iː n ɛ n t a m	d eː s ɪ n ɛ n t j a m
ɪ m p a r t iː r ɛ	ɪ m p a r t iː r ɛ
m a m ɛ lː a m	m a m ɪ lː a m
d iː s iː m iː l ɛ	d ɪ sː ɪ m ɪ l ɛ m
l kʷ ɛ r m k j ʊ m	kʷ ɛ r k ʊ m
k a d ʊ k ʊ m	k a d uː k ʊ m
a m r j ʊ m l ʊ m	h a r ɪ ɔ l ʊ m
g ʊ ŋ g ɛu m r ɛ	j ʊ ŋ g ɛ r ɛ
a m n ʊ t ɪ n ʊ m	a nː oː t ɪ n ʊ m
p r ɔ w ɔ k aː r ɛ	p r oː w ɔ k aː r ɛ
ɪ n t m ɛ rː ʊ m p ɛ r ɛ	ɪ n t ɛ rː ʊ m p ɛ r ɛ
k ʊ n d n a m t j oː n ɛ m	k ɔ n d ɛ m n aː t j oː n ɛ m
t ɛ k s t ʊ m	t ɛ k s t ʊ m
l ʊ k ɛ r n a m	l ʊ k ɛ r n a m
k oː l oː n ʊ m	k ɔ l oː n ʊ m
t iː s iː k ʊ m	p eː h tʰ ɪ s ɪ k ʊ m
g ɛ n j a l ɛ	g ɛ n j aː l ɛ m
ɪ ŋ kʷ ɪ n ɛ	ɪ ŋ gʷ ɛ n
s iː t a s j ɛ m	k ɪ t aː t j oː n ɛ m
g r a n aː t ʊ m	g r aː n aː t ʊ m
a n a r k j a m	a n a r kʰ j a m
aʊ r iː r	h aʊ r iː r ɛ
m a l w a m	m a l w a m
k a n kː ɛ r ʊ m	k a ŋ k r ʊ m
n a m d a m d ɔ r	n a t aː t oː r ɛ m
a b s k iː s a m	a b s k ɪ n d ɛ r ɛ
ɔ k ʊ rː ɛ r ɛ	ɔ kː ʊ rː ɛ r ɛ
ɛ r ɔ m p ɛ r ɛ	eː r ʊ m p ɛ r ɛ
ɛ m ʊ l ʊ m	aɪ m ʊ l ʊ m
w eː n ɛ t r oː m ʊ m a	w ɛ n ɛ t ʊ m
k ɔ n s uː d m aː r	k oː n s ʊ mː aː r ɛ
t a n t ʊ m	t a n t ʊ m
k ɔ n s ɛ ʊ m	k oː n s k j ʊ m
t ɛ d j oː s ʊ m	t aɪ d j oː s ʊ m
g ʊ g ɛ m l a m	z iː z y pʰ ʊ m
d iː s t iː n k t ʊ m	d ɪ s t ɪ ŋ k t ʊ m
r aː p ʊ m	r aː p ʊ m
p iː n aː k ʊ l ʊ m	p ɪ nː aː k ʊ l ʊ m
f ʊ l g ʊ m r ɛ	f ʊ l g oː r ɛ m
a l t ɛ r k aː r ɛ	a l t ɛ r k aː r iː
r a m k ɪ m ɔ s ʊ m	r a k eː m oː s ʊ m
a b n ɛ g aː r ɛ	a b n ɛ g aː r ɛ
t r a m s m iː g r a m r ɛ	t r aː n s m ɪ g r aː r ɛ
g ʊ m ɛ n t ʊ m	j uː m ɛ n t ʊ m
r ɛ w ɔ k aː r ɛ	r ɛ w ɔ k aː r ɛ
a b iː t a t j oː n ɛ m	h a b ɪ t aː t j oː n ɛ m
p ʊ l s aː r ɛ	p ʊ l s aː r ɛ
ɛ k s t r ʊ d iː r	ɛ k s t r uː d ɛ r ɛ
m t ɛ m p ɛ r aː r ɛ	t ɛ m p ɛ r aː r ɛ
p a r t iː t j oː n ɛ m	p a r t iː t j oː n ɛ m
w iː p t ʊ m	w iː k t ʊ m
w ɛ lː ʊ m	w ɪ lː ʊ m
aː n a l ɪ	a nː aː l ɛ m
n ɔ ɛ w ʊ m	n ɔ w ʊ m
r ɛ k ʊ n ɔ s ɛ r ɛ	r ɛ k ɔ ŋ n oː s k ɛ r ɛ
ʊ s iː t aː r ɛ	uː s ɪ t aː r iː
d aː t ʊ m	d a t ʊ m
m ɛ t a lː ʊ m	m ɛ t a lː ʊ m
t ɔ p s ɪ k aː r ɛ	t ɔ k s ɪ k aː r ɛ
s ʊ g h ɛ k t ʊ m	s ʊ b ɪ ɛ k t ʊ m
w ɛ k sː a t j oː n ɛ m	w ɛ k s aː t j oː n ɛ m
k ɔ n w ɛ r t iː r ɛ	k ɔ n w ɛ r t ɛ r ɛ
k iː s m ɪ k ɛ	k iː m ɪ k ɛ m
a pː r ɔ b a t j oː n ɛ m	a pː r ɔ b aː t j oː n ɛ m
k a l ɔ s t r ʊ m	k ɔ l ɔ s t r a m
a m n aː t aː	a n a t ɛ m
k ɔ m p l ɛ m ɛ ŋ t ʊ m	k ɔ m p l eː m ɛ n t ʊ m
ʊ r k ɛ	ʊ l iː k ɛ m
d ɛ t ɛ r m iː n a m t j ʊ m n ɛ	d eː t ɛ r m ɪ n aː t j oː n ɛ m
l a k t ɛ ʊ m	l a k t ɛu m
a b dː ɔ m ɛ n	a b d oː m ɛ n
f ʊ g aː k ɛ	f ʊ g aː k ɛ m
ɪ n k a r n aː r ɛ	ɪ ŋ k a r n aː r ɛ
p r ɔ k ʊ r aː r ɛ	p r oː k uː r aː r ɛ
r ʊ b r iː k a m	r ʊ b r iː k a m
p a l ʊ m b aː r ʊ m	p a l ʊ m b aː r j ʊ m
m a k s ɛ lː aː r ɛ	m a k s ɪ lː a r ɛ m
a f ɛ k t j oː n ɛ m	a fː ɛ k t j oː n ɛ m
f ɔ l oː s ʊ m	f ɔ l j oː s ʊ m
k a n iː n ʊ m	k a n iː n ʊ m
f iː l ɔ s ɔ f j a m	pʰ ɪ l ɔ s ɔ pʰ j a m
a b iː m ʊ m	a b y sː ʊ m
ɛ s t r ɛ m ɛ k ɛ r	t r ɛ m eː s k ɛ r ɛ
f ɛ d ɛ l ɛ	f ɪ d eː l ɛ m
w oː m ɛ r ɛ	w oː m ɛ r ɛ m
d iː f a m a t oː r j ʊ m	d ɪ fː aː m aː t oː r j ʊ m
a m pː ɔ s t ʊ m	a pː ɔ s ɪ t ʊ m
t ɛ t r ʊ m	t aɪ t r ʊ m
n iː m j ʊ m	n ɪ m j ʊ m
r eː t ɛ n ɛ r ɛ	r ɛ t ɪ n eː r ɛ
a s iː s t ɛ r ɛ	a sː ɪ s t ɛ r ɛ
w oː m ɪ t ʊ m	w ɔ m ɪ t ʊ m
a r ɔ m a t iː k ʊ m	a r oː m a t ɪ k ʊ m
iː n t ɛ r k ɛ d ɛ r ɛ	ɪ n t ɛ r k eː d ɛ r ɛ
g iː b ɛu m	g ɪ bː ʊ m
ɛ k s t r iː n s ɛ k ʊ m	ɛ k s t r iː n s ɛ k ʊ m
m a l ɛ d ɪ k ɛ r ɛ	m a l ɛ d iː k ɛ r ɛ
t ɛ s t ɪ m ɔ n j ʊ m	t ɛ s t ɪ m oː n j ʊ m
t a k s aː r ɛ	t a k s aː r ɛ
k ɔ a b iː t a m r ɛ	k ɔ h a b ɪ t aː r ɛ
m ɛ d j ɔ k r ɛ	m ɛ d ɪ ɔ k r ɛ m
d ɛ n ɔ m iː n a t j oː n ɛ m	d eː n oː m ɪ n aː t j oː n ɛ m
d j oː s	d ɛu m
k ɔ n s ɛ n t iː r ɛ	k oː n s ɛ n t iː r ɛ
s a g ɪ t aː r j ʊ m	s a g ɪ tː aː r j ʊ m
a n t iː k iː p a m r ɛ	a n t ɪ k ɪ p aː r ɛ
s ʊ p ɛ r w a m k aː n ɛ ʊ m	s ʊ p ɛ r w a k ʊː m
p aː r d ʊ m	p a r d ʊ m
iː rː iː g a m r ɛ	ɪ rː ɪ g aː r ɛ
k eː m ɛ n t ʊ m	k aɪ m ɛ n t ʊ m
b ʊ k s ʊ m	b ʊ k s ʊ m
a m r m iː g ɛ r ʊ m	a r m ɪ g ɛ r ʊ m
f iː n a m	f aː g ɪ n ʊ m
k ɛ r w a m	k ɛ r w a m
s a n t ʊ m r j ɛ t a m	s a t ʊ r eː j a m
a m n ɔ d iː n ʊ m	a n oː d y n ɔ n
k a r a m ɛ lː ʊ m	k a l a m ɛ lː ʊ m
k ɔ m ɛ r k j a l ɛ	k ɔ mː ɛ r k j aː l ɛ m
s p ʊ m oː s ʊ m	s p uː m oː s ʊ m
a d ʊ l a t j oː n	a d uː l aː t j oː n ɛ m
r ɛ n ʊ n k j aː r ɛ	r ɛ n ʊ n t j aː r ɛ
l ʊ k r aː r ɛ	l ʊ k r aː r iː
a gː r a w aː r ɛ	a gː r a w aː r ɛ
k ɔ n t a m iː n a t j oː n ɛ m	k ɔ n t aː m ɪ n aː t j oː n ɛ m
r ɛ p r ɛ ɛ n s iː b ɪ l ɛ	r ɛ p r ɛ h ɛ n s ɪ b ɪ l ɛ m
b a k ɪ l j ɛ	b a kː a l aʊ r ɛu m
f aː h m a m	f aː m a m
m a m n ʊ b r j ʊ m	m a n uː b r j ʊ m
k ɔ n k ɔ r d j a m	k ɔ ŋ k ɔ r d j a m
aː b ɪ t ʊ m	h a b ɪ t ʊ m
b a s iː l iː k ʊ m	b a s ɪ l ɪ k ʊ m
m aː g ʊ m	m a g ʊ m
aː s a m r ʊ m	a s a r ʊ m
ɔ l ɔ r	ɔ l oː r ɛ m
ɛ s ɛ k r ɛ t ɪ	s k r iː p t ʊ m
k r a m t ɪ k ʊ l a m	k r aː t ɪ k ʊ l a m
a m lː ɪ w j aː r ɛ	a lː ɛ w j aː r ɛ
ɛ s t ɛ r n ʊ m	h ɛ s t ɛ r n ʊ m
p r oː w a m	p r ɔ b a m
iː n d ʊ l ɛ	ɪ n d ɔ l ɛ m
w ɪ t r ʊ m	w ɪ t r ʊ m
n oː ɪ s	n oː s
k a r aː k t ɛ r ɛ	kʰ a r a k t eː r ɛ m
b a l t ɛ ʊ m	b a l t ɛu m
k ɔ n k r ɛ t j ʊ m n ɛ	k ɔ ŋ k r eː t j oː n ɛ m
ɔ n ɔ r aː r j ʊ m	h ɔ n oː r aː r j ʊ m
k ʊ n t ʊ r b aː r ɛ	k ɔ n t ʊ r b aː r ɛ
s ʊ n aː t ʊ m	s ɔ m n j ʊ m
r ɛ l ʊ k ɛ r ɛ	r ɛ l uː k eː r ɛ
s ɛ	s eː
iː m aː g ɪ n ɛ	ɪ m aː g ɪ n ɛ m
p a l m ʊ m	p a l m ʊ m
r ɛ k a t aː r	r ɛ k a p t j aː r ɛ
s ʊ ɛ m b ʊ k ʊ m	s a m b uː k ʊ m
h ɔ s t j a m	h ɔ s t j a m
f a r ɛ t r a m	pʰ a r ɛ t r a m
f r ɛ kʷ ɛ n t ɛ m	f r ɛ kʷ ɛ n t ɛ m
l ɛ p r ʊ m s ʊ m	l ɛ p r oː s ʊ m
k ʊ m m ʊ w ɛ r ɛ	k ɔ mː ɔ w eː r ɛ
iː ŋ g ʊ s t ʊ m	ɪ n ɪ uː s t ʊ m
p ɔ n t iː f iː k aː t ʊ m	p ɔ n t ɪ f ɪ k aː t ʊ m
p l a t a n ʊ m	p l a t a n ʊ m
p r ɛ t ɛ r iː r	p r aɪ t ɛ r iː r ɛ
s t aː b ɪ l ɛ	s t a b ɪ l ɛ m
dː ʊ lː k oː r ɛ	d ʊ l k oː r ɛ m
r ɛ w ɔ k a t j oː n ɛ m	r ɛ w ɔ k aː t j oː n ɛ m
ɪ n f ɛ r m ɪ t a t ɛ m	iː n f ɪ r m ɪ t aː t ɛ m
s p ʊ m r k aː r ɛ	s p ʊ r k aː r ɛ
ɛ r g aː s t ʊ l ʊ m	ɛ r g a s t ʊ l ʊ m
n aː f t a m	n a pʰ tʰ a m
l ʊ m k aː r ɛ	l ɔ k aː r ɛ
p ɔ l ʊ ɛ r	p ɔ lː ʊ ɛ r ɛ
d iː s w aː d ɛ r ɛ	d ɪ sː w aː d eː r ɛ
k iː g ɔ n a m	k ɪ k oː n j a m
k ɔ n s ɪ l ʊ m	k ɔ ŋ k ɪ l j ʊ m
