d eː h ɛ s p ɛ r aː t ʊ m	d eː s p eː r aː t ʊ m
d ʊ ɛ k j eː n t oː s	d ʊ k ɛ n t oː s
a m iː k aː l ɛ	a m iː k aː l ɛ m
k ɔ n d ɪ t ɛ n d ɛ r ɛ m	k ɔ n d eː s k ɛ n d ɛ r ɛ
m a n a m	m a rː a m
j uː b g ʊ l aː r ɛ	j ʊ g ʊ l aː r ɛ
kʷ a t r aː t ʊ m	kʷ a d r aː t ʊ m
ɪ n f l aː t j ɛu n ɛ m	iː n f l aː t j oː n ɛ m
w ɔ l ʊ b ɪ l ɛ m	w ɔ l uː b ɪ l ɛ m
a d ʊ m b r aː r ɛ	a d ʊ m b r aː r ɛ
w ɪ n ɛ t ʊ m	w iː n eː t ʊ m
a oː w ɛ r t ɪ r ɛ	a d w ɛ r t ɛ r ɛ
m ɪ l ɛ j ɛ r m aː r ʊ m	m iː lː j aː r j ʊ m
l ɔ kː aː k ɛ	l ɔ kʷ aː k ɛ m
a r g ʊ ɛ r ɛ	a r gʷ ɛ r ɛ
s k a n d ɪ r ɛ	s k a n d ɛ r ɛ
aʊ r iː g a m	aʊ r iː g a m
ɪ n ɪ ʊ k t j oː n ɛ m	ɪ n j ʊ ŋ k t j oː n ɛ m
d ɛ p aː r t ɪ r ɛ m	d eː p a r t iː r ɛ
d ɛ m ɔ ŋ r aː r ɛ	d eː m ɔ r aː r iː
d eː n ɛ g aː r iː	d eː n ɛ g aː r ɛ
f ɛ s t ɪ w ʊ m	f ɛ s t iː w ʊ m
k ɔ l ʊ m b ʊ m	k ɔ l ʊ m b ʊ m
a m ɛ n t	aː m ɛ n t ɛ m
g l ɔ t oː n ɛ	g l ʊ tː oː n ɛ m
aɪ tʰ ɛ r ɛ	aɪ tʰ ɛ r ɛ m
l a k t aː r ʊ m	l a k t aː r j ʊ m
a tː iː ŋ g ɛ r ɛ	a tː ɪ ŋ g ɛ r ɛ
k ɔ n s ɔ r t ɛ m	k oː n s ɔ r t ɛ m
k s p a n d ɛ r ɛ	ɛ k s p a n d ɛ r ɛ
g eː r ɪ r ɛ	g ɛ r ɛ r ɛ
ɪ n k ɔ m p ɛ t ɛ n t ɛ m	ɪ ŋ k ɔ m p ɛ t ɛ n t ɛ m
t r uː k ʊ l eː n t ʊ m	t r ʊ k ʊ l ɛ n t ʊ m
s ɔ n rː ɪ d ɪ r ɛ	s ʊ b r iː d eː r ɛ
a pː a r aː t ʊ m	a pː a r aː t ʊ m
p ʊ pː a m	p ʊ pː ɛ m
b a r b aː r ɪ m ʊ m	b a r b a r ɪ s m ʊ m
w iː tʰ ʊ m	w ɔ k ɪ t ʊ m
s a n aː b ɪ l ɛ m	s aː n aː b ɪ l ɛ m
s ɔ l ɪ k ɪ t aː r ɛ	s ɔ lː ɪ k ɪ t aː r ɛ
k ɪ ɔ n kʷ ɛ r ɛ	kʷ ɛ m k ʊ m kʷ ɛ
s ɛu g ɛ lː ʊ m	s ɪ g ɪ lː ʊ m
s ɪ n t ɪ p uː a m	s ɪ ŋ k ɪ p ʊ t
b a l t ɛu m ʊ m	b a l t ɛu m
ɛ fː ʊ n d ɛ r ɛ	ɛ fː ʊ n d ɛ r ɛ
a b iː t aː t j oː n ɛ m	h a b ɪ t aː t j oː n ɛ m
f uː ɪ n a m	f aː g ɪ n ʊ m
p r ɛ m ɛ r ɛ	p r ɛ m ɛ r ɛ
ʊ ŋ gː ɛ n t ʊ m	ʊ ŋ gʷ ɛ n t ʊ m
l ɔ t ʊ m	l ʊ t ʊ m
a k j ɔ l y t eː r ʊ m	a d ʊ l t ɛ r ʊ m
p l a n t ʊ m	p l a ŋ k t ʊ m
a nː ɪ k ɔ s ʊ m	a nː oː s ʊ m
n ɔ m iː n aː t j oː n ɛ m	n oː m ɪ n aː t j oː n ɛ m
ɛ k s a k eː n r b aː t j oː n ɛ m	ɛ k s a k ɛ r b aː t j oː n ɛ m
k ɔ s k ʊ m	k ɔ k s ʊ m
ɪ m p ɛ r ɪ t j a m	ɪ m p ɛ r iː t j a m
p ɛ k ʊ n j aː	p ɛ k uː n j a m
k ɛ r n ɛ r ɛ	k ɛ r n ɛ r ɛ
ɪ n s ʊ l s ʊ m	iː n s ʊ l s ʊ m
s p ɛ k t aː k ʊ l ʊ m	s p ɛ k t aː k ʊ l ʊ m
k aː s t ɪ g aː r ɛ	k a s t iː g aː r ɛ
p r ɛ k ɛ aː r ɛ	p r ɛ k aː r iː
n ɔ d oː s ʊ m	n oː d oː s ʊ m
w a r ɛ r ɛ	w ɛ rː ɛ r ɛ
m ɛ r iː t aː r ɛ	m ɛ r eː r ɛ
f a s t ɪ d j ʊ m	f a s t iː d j ʊ m
d ɔ t aː t j oː n ɛ m	d oː t aː t j oː n ɛ m
a k k ɛ s ʊ m	a kː ɛ sː ʊ m
f a k s t j ɛ m	f a s k ɛ m
w ɛ n d eː m j a m	w iː n d eː m j a m
k ɔ n s ɪ s t ɛ r ɛ	k oː n s ɪ s t ɛ r ɛ
k l uː t ɪ n ɛ	g l uː t ɛ n
n uː m ɛ r ɔ s ʊ m	n ʊ m ɛ r oː s ʊ m
a l a b a s t r ʊ m	a l a b a s t r ʊ m
ɔ t ʊ ɛ r j ʊ m	ɔ sː w aː r j ʊ m
ɔ b s ɛ r w aː r ɛ	ɔ b s ɛ r w aː r ɛ
kʷ ɛ s t j ɔ n aː r j ʊ m	kʷ aɪ s t j oː n aː r j ʊ m
a m iː k t ʊ m	a m ɪ k t ʊ m
ɪ n d iː ŋ n aː r ɛ	ɪ n d ɪ ŋ n aː r iː
g r aː n d ɪ k ʊ m	g r a n d ɪ n ɛ m
r ɪ eː n ɛ m	r eː n ɛ m
k ɔ rː ɛ g t oː r ɛ	k ɔ rː ɛ k t oː r ɛ m
f r aː t ɛ r n ɪ t aː t ɛ m	f r aː t ɛ r n ɪ t aː t ɛ m
t ɛ s t ɪ m oː n j ʊ m	t ɛ s t ɪ m oː n j ʊ m
k ɪ r k ʊ n d aː r ɛ m	k ɪ r k ʊ m d a r ɛ
kʷ l ʊ k aː r ɛ	g l oː k iː r ɛ
ɔ n ɛ eː s k a m	h ɔ n ɛ s t aː t ɛ m
r aː s ɛ k aː r ɛ	r ɛ s ɛ k aː r ɛ
ɛ k s ɛ k r aː t j oː n ɛ m	ɛ k sː eː k r aː t j oː n ɛ m
ɪ m f ɛ kʷ t aː r ɛ	iː n f ɪ k ɛ r ɛ
k a l w ʊ m	k a l w ʊ m
a n iː h ɪ l aː t j oː n ɛ m	a nː ɪ h ɪ l aː t j oː n ɛ m
s ɛ p aː r aː r ɛ	s eː p a r aː r ɛ
ɪ rː ɛ g ʊ l aː r ɛ	ɪ rː eː g ʊ l aː r ɛ m
k a mː ɪ n ʊ m	k a mː iː n ʊ m
a fː uː m ɪ k aː r ɛ	f uː m ɪ g aː r ɛ
p a l d aː r ɛ lː a m	p a t ɛ lː a m
d eː k ɪ t uː oː n j ʊ r ɛ	d eː k ɪ p ɛ r ɛ
a rː h ɔ g aː r ɛ	a rː ɔ g aː r ɛ
k ɔ l ɛ k j ʊ m	k aʊ l ɪ k ʊ l ʊ m
p l aː t ɛ a m	p l a t eːa m
ɪ eː m a l ɔ w l j eː r ɛ	eː m ɔ w eː r ɛ
p ɪ s aː r ɛ	p iː n s ɛ r ɛ
ɪ n t ɛ r d ɪ n ɪ r ɛ r ɛ	ɪ n t ɛ r d iː k ɛ r ɛ
b a s iː l ɪ s k ʊ m	b a s ɪ l ɪ s k ʊ m
ɪ ŋ ɔ s ɛ r ɛ	ɪ ŋ n oː s k ɛ r ɛ
f ʊ n d ɪ b uː l ʊ m	f ʊ n d ɪ b ʊ l ʊ m
m ɪ t iː g aː r ɛ	m iː t ɪ g aː r ɛ
p ɔ lː aː r j ʊ m	p ʊ lː aː r j ʊ m
s ʊ mː iː n ɪ s t r aː r ɛ m	s ʊ b m ɪ n ɪ s t r aː r ɛ
ɔ m iː k ɪ t j ʊ m	h ɔ m ɪ k iː d j ʊ m
ɪ n k a p aː m	ɪ ŋ k a p aː k ɛ m
a m b oː s	a m b oː s
ɪ ŋ ɪ ɛ r iː r ɛ	ɪ ŋ g ɛ r ɛ r ɛ
ɛ s p ɪ r aː r ɛ	s p iː r aː r ɛ
f uː n ɛ r ɛ ʊ m	f uː n ɛ r ɛu m
m a n aː r ɛ	m aː n aː r ɛ
g r aː t j oː s ʊ m	g r aː t j oː s ʊ m
m ɔ r d aː k ɛ	m ɔ r d aː k ɛ m
a ŋ g oː l a m	a ŋ g ʊ s t j a m
k ɔ l ʊ m b ɪ n ʊ m	k ɔ l ʊ m b iː n ʊ m
d ɪ s t ɛ n d ɛ r ɛ	d ɪ s t ɛ n d ɛ r ɛ
ɔ r ɪ ɛ n t aː l ɛ	ɔ r ɪ ɛ n t aː l ɛ m
k a t ʊ m	k aʊ t ʊ m
k ɔ lː ɛ m	k ɔ lː ɛ m
p ɔ s t ʊ l aː r ɛ	p ɔ s t ʊ l aː r ɛ
a dː ɔ r m iː r ɛ	a dː ɔ r m iː r ɛ
l a b ɔ r ɛ	l a b oː r ɛ m
ɛ s k t ɔ t ɛ r ɛ	ɛ k s k ʊ t ɛ r ɛ
d eː l iː n kʷ ɛ r ɛ	d eː l ɪ ŋ kʷ ɛ r ɛ
ʊ r t ɛ m	ʊ l iː k ɛ m
eː n t ɛ m	ɛ n s
r ɛ f r ɪ g eː r j ʊ m	r eː f r iː g ɛ r j ʊ m
a m ɛ t ɪ s t a m	a m ɛ tʰ y s t a m
ɪ n d iː s k r ɛ t j oː n ɛ m	ɪ n d ɪ s k r eː t j oː n ɛ m
r ɔ b ɪ ʊ ɪ m	r oː b iː g ɪ n ɛ m
t a r d ɪ m	t a r d ʊ m
k ɔ n j ʊ g aː t j oː n ɛ m	k ɔ n j ʊ g aː t j oː n ɛ m
a b ɛ n a m	a w eː n a m
k ɔ d ɪ k ɛ m	k oː d ɪ k ɛ m
s ɛ r p ɛ n t ɪ n ʊ m	s ɛ r p ɛ n t iː n ʊ m
w ɛ n ɛ t d t n a ɛ	w ɛ n ɛ t ʊ m
a s iː m ɪ l aː r ɛ	a sː ɪ m ʊ l aː r ɛ
ɪ n t ɛ g r aː r ɛ	ɪ n t ɛ g r aː r ɛ
d uː k aː t ʊ m	d ʊ k aː t ʊ m
p r ɔ p ʊ ŋ n aː r ɛ	p r oː p ʊ ŋ n aː r ɛ
s aː l m a m	s a g m a m
r ɛ s t aː r ɛ	r ɛ s t aː r ɛ
m ɛ n ʊ t j a n	m ɪ n uː t j a m
l uː k s ʊ r j a m	l ʊ k s ʊ r j a m
m a t aː s a m	m a t a k s a m
f l uː w j aː l ɛ	f l ʊ w j aː l ɛ m
w ɪ g a m	b iː g a m
ɪ m p iː ŋ g ɛ r ɛ	ɪ m p ɪ ŋ g ɛ r ɛ
uː n k iː n ʊ m	ʊ ŋ k iː n ʊ m
r ɛ k ɛ p t aː r ɛ	r ɛ k ɛ p t aː r ɛ
s uː t ʊ r a m	s uː t uː r a m
p ɛ k ɔ r a m	p ɛ k ʊ s
aɪ r ɛ d aː r ɛ	h eː r eː d ɪ t aː r ɛ
s ɔ n ʊ m	s ɔ n ʊ m
a r k ɛ r ʊ m	a r k w aː r j ʊ m
w oː m ɪ t ʊ m	w ɔ m ɪ t ʊ m
a b iː d ɪ t ɛ m	a w ɪ d ɪ t aː t ɛ m
r ɛ k t a ŋ g ʊ l ʊ m	r ɛ k t a ŋ g ʊ l ʊ m
t ɪ p ʊ l a m	t ɪ pː ʊ l a m
s t r ɪ g a m	s t r iː g a m
p r ɔ t ɛ l a m	p r ɔ k ɛ lː a m
a p k aː r ɛ	a d w ɔ k aː r ɛ
ɪ l aː t j oː n ɛ m	ɪ lː aː t j oː n ɛ m
d eː l iː n kʷ ɛ n t j a m	d eː l ɪ ŋ kʷ ɛ n t j a m
k a d aː w eː r ɛ	k a d aː w ɛ r
s ɔ l ɪ k ɪ t uː d ɪ n ɛ m	s ɔ lː ɪ k ɪ t uː d ɪ n ɛ m
eː b ɔ k aː t j oː n ɛ m	eː w ɔ k aː t j oː n ɛ m
ɪ n k a r n aː r ɛ	ɪ ŋ k a r n aː r ɛ
k ɔ n t r ɪ t j oː n ɛ m	k ɔ n t r iː t j oː n ɛ m
f ɔ r k m aː g	f oː r m aː t ɪ k ʊ m
ɪ ŋ n ɛ ʊ m	ɪ ŋ n ɛu m
a n ɛ g aː r ɛ	eː n ɛ k aː r ɛ
a l aː g eː n aː r ɛ	a l ɪ eː n aː r ɛ
d aː m b uː l aː t j oː n ɛ m	d ɛ a m b ʊ l aː t j oː n ɛ m
p a s t ɪ k n aː k ɛ m	p a s t ɪ n aː k a m
k a p aː k ɛ	k a p aː k ɛ m
f l aː m a m	f l a mː a m
s ɛ g r ɛ g aː r ɛ	s eː g r ɛ g aː r ɛ
a k uː m ɪ n aː r ɛ	a k uː m ɪ n aː r ɛ
a g aː p ɛ m	a g a p eː n
k uː l t oː r ɛ	k ʊ l t oː r ɛ m
p ɔ m eː k ɛ m	p uː m ɪ k ɛ m
ɪ n f iː g eː r ɛ	iː n f iː g ɛ r ɛ
ɪ ŋ n aː r ʊ m	ɪ ŋ n aː r ʊ m
ɪ n eː ɪ b r j ɛ r ɛ	ɪ n eː b r j aː r ɛ
d ɛ p r ɛ d aː t j oː n ɛ m	d eː p r aɪ d aː t j oː n ɛ m
n a t a l ɪ t j ʊ m	n aː t aː l iː k j ʊ m
ɔ r k ʊ m	ɔ r k ʊ m
t r iː t ɛ	t r iː k ɛ m
m ɔ r d ɛ r ɛ	m ɔ r d eː r ɛ
n ɪ d oː r ɛ	n iː d oː r ɛ m
ɪ m p ɛ r j oː s ʊ m	ɪ m p ɛ r j oː s ʊ m
r ɛ a b ɪ t aː t ɛ m	r ɛ aː l ɪ t aː t ɛ m
p a k iː f ɪ k ʊ m	p aː k ɪ f ɪ k ʊ m
n ɛ r w ʊ m	n ɛ r w ʊ m
b a k ʊ a l oː r aː t ʊ m	b a kː a l aʊ r ɛ a t ʊ m
kʷ ɛ s ɪ t ʊ m	kʷ aɪ s iː t ʊ m
p ɛ r m ɪ t ɛ r ɛ	p ɛ r m ɪ tː ɛ r ɛ
r ɔ k ʊ m	r aʊ k ʊ m
s k ɪ r p ʊ m	s k ɪ r p ʊ m
r ɛ g ʊ l a m	r eː g ʊ l a m
l uː m iː n oː s ʊ m	l uː m ɪ n oː s ʊ m
f ɪ b ʊ l a m	f iː b ʊ l a m
w a k ʊ ɪ t aː t ɛ m	w a k ʊ ɪ t aː t ɛ m
a n aː l ɪ s ɛ m	a n a l y s ɛ m
s k ʊ rː a m	s k ʊ rː a m
l uː k r ʊ m	l ʊ k r ʊ m
m a t ʊ t iː n ʊ m	m aː t uː t iː n ʊ m
a r k aː n ʊ m	a r k a n ʊ m
a n ɔ n a m	a nː oː n a m
l a k r ɪ m oː s ʊ m	l a k r ɪ m oː s ʊ m
f a l a ŋ g ɛ m	pʰ a l a ŋ g ɛ m
r uː m iː n aː r ɛ	r uː m ɪ n aː r iː
k r ɛ m a m	k r aː m ʊ m
w ɛ r iː f ɪ k aː t j oː n ɛ m	w ɛ r ɪ f ɪ k aː t j oː n ɛ m
a b s k ɪ s ʊ m	a b s k ɪ n d ɛ r ɛ
h s aɪ ŋ p uː l aː r ɛ	s ɛ p ɛ l iː r ɛ
s ɔ gː l j ɔ t ʊ m	s ɪ ŋ g ʊ l t ʊ m
k ɔ ɔ j aː ɪ ʊ m	k ɔ mː ɛ aː t ʊ m
w ɛ h s aː r ɛ	w eː k s aː r ɛ
f l uː ɪ r ɛ	f l ʊ ɛ r ɛ
p a w iː d ʊ m	p a w ɪ d ʊ m
ɔ p uː l ɛ n t ʊ m	ɔ p ʊ l ɛ n t ʊ m
a n w ʊ m	a nː ʊː m
p r ɔ k ʊ r aː r ɛ	p r oː k uː r aː r ɛ
m ɪ r t ʊ m	m y r t ʊ m
w a r j ʊ m	w a r j ʊ m
f r aɪ n aː r ɛ	f r eː n aː r ɛ
ɔ pː ɔ r t uː n ɪ t aː t ɛ m	ɔ pː ɔ r t uː n ɪ t aː t ɛ m
w ɛ s t ɪ r ɛ	w ɛ s t iː r ɛ
uː l k ɛ r a m	ʊ l k ʊ s
k r iː m ɪ ŋ ɛ	k r iː m ɛ n
p a ɛ s ɛ	p aː g eː n s ɛ m
b r iː t aː n ɪ k ʊ m	b r ɪ t a nː ɪ k ʊ m
p a s aː r ɛ	p a n d ɛ r ɛ
ɪ m p ɛ r j ʊ m	ɪ m p ɛ r j ʊ m
l ɛ g aː t ʊ m	l eː g aː t ʊ m
m a t ɛ r n ɪ t aː t ɛ m	m aː t ɛ r n ɪ t aː t ɛ m
eː d iː f ɪ k aː r ɛ	aɪ d ɪ f ɪ k aː r ɛ
k ɔ m a n d aː r ɛ	k ɔ mː ɛ n d aː r ɛ
s a l k ɪ k ɛ m	s a l ɪ k ɛ m
ɛ k s p ɛ d j ɪ r ɛ	ɛ k s p ɛ d iː r ɛ
t r aː n s m ɪ t ɛ r ɛ m	t r aː n s m ɪ tː ɛ r ɛ
ɪ n d ɔ l ɛ m	ɪ n d ɔ l ɛ m
p a l j ʊ m	p a lː j ʊ m
w ɛ t a m	w ɪ tː a m
k ɔ n f ɛ r eː r ɛ	k oː n f ɛ rː ɛ
eː m uː l a k t oː r ɛ	aɪ m ʊ l aː t oː r ɛ m
s ɔ m ɪ ɛ r ɛ	s a g m aː r j ʊ m
m iː g r aː r ɛ	m ɪ g r aː r ɛ
ɪ n s t aʊ r aː r ɛ	iː n s t aʊ r aː r ɛ
uː s iː t aː t ʊ m	uː s ɪ t aː t ʊ m
p uː n aː r ɛ	p ʊ ŋ n aː r ɛ
s a l iː n a m	s a l iː n a m
ɪ mː a t ʊ r ʊ m	ɪ mː aː t uː r ʊ m
k ɔ n s oː l aː t j oː n ɛ m	k oː n s oː l aː t j oː n ɛ m
ɛ k s ʊ l k ɛ r aː t j oː n ɛ m	ɛ k s ʊ l k ɛ r aː t j oː n ɛ m
p ɛ r m ɪ s j oː n ɛ m	p ɛ r m ɪ sː j oː n ɛ m
r a n ʊ k	r aː n ʊ ŋ k ʊ l ʊ m
g r a n aː j oː n ʊ m	g r aː n aː r j ʊ m
a k t w aː r ɛ	aː k t w aː r ɛ
k uː r ɪ t ʊ r a m	k uː r aː t uː r a m
k ɔ n s ɔ n aː r ɛ	k oː n s ɔ n aː r ɛ
a m iː k a m	a m iː k a m
p ɛ r t uː r b aː t j oː n ɛ m	p ɛ r t ʊ r b aː t j oː n ɛ m
ɪ mː ɔ r t aː l ɛ m	ɪ mː ɔ r t aː l ɛ m
a g r ʊ m	a g r ʊ m
eː pː iː s t oː l a m	ɛ p ɪ s t ɔ l a m
ɔ n ɔ r aː r j ʊ m	h ɔ n oː r aː r j ʊ m
d eː n ɔ m ɪ n aː t j oː n ɛ m	d eː n oː m ɪ n aː t j oː n ɛ m
m eː d ɪ ʊ m	m ɛ d j ʊ m
ɔ s t eː n t aː r ɛ	ɔ s t ɛ n t aː r ɛ
r ɪ s ɪ d ɛ r ɛ	r ɛ s ɪ d eː r ɛ
p ɛ r iː m ɛ r ɛ	p ɛ r ɪ m ɛ r ɛ
f t ɪ r ɛ	f ɔ d ɛ r ɛ
t r iː n j s aː t ɛ m	t r iː n ɪ t aː t ɛ m
p ɪ s t r iː n ʊ m	p ɪ s t r iː n ʊ m
s t r ɪ g ɛ m	s t r ɪ g ɛ m
a g ʊ m	a k ʊ m
t aʊ r iː f oː r m ɛ	t aʊ r ɪ f oː r m ɛ m
a n t iː s t ɛ r ɛ m	a n t ɪ s t ɪ t ɛ m
b ɔ m b ʊ m	b ɔ m b ʊ m
s ɔ n ʊ m	s ɔ m n ʊ m
s ɛ n aː r ɛ	s ɪ ŋ n aː r ɛ
j ʊ b ɛ n k a m	j ʊ w ɛ ŋ k a m
p ɔ m ʊ m	p oː m ʊ m
w ɛ r ɛ k ʊ m d ʊ m	w ɛ r eː k ʊ n d ʊ m
a d uː r aː t j ɛ m	a d ɪ uː r aː t j oː n ɛ m
r ɔ n k aː r ɛ	r h ɔ ŋ kʰ aː r ɛ
ɛ k s iː g ɛ r ɛ	ɛ k s ɪ g ɛ r ɛ
k ɛu l ɔ s t r ʊ m	k ɔ l ɔ s t r a m
h aː ɪ ʊ n aː r ɛ	j eː j uː n aː r ɛ
aː n k pʰ ŋ	iː l ɪ k ɛ m
w ɪ w iː d ʊ m	w iː w ɪ d ʊ m
s a k r ɪ l ɛ g ʊ m	s a k r ɪ l ɛ g ʊ m
f a r m aː k ɛ ʊ t ɪ k ʊ m	pʰ a r m a k ɛu t ɪ k ʊ m
ɪ n f ɛ l ɪ k ɛ	iː n f eː l iː k ɛ m
b ɔ t ʊ l iː n ʊ m	b ɔ t ʊ l ʊ m
k ɛ r ɛ m oː n j aː l ɛ m	k aɪ r ɪ m oː n j aː l ɛ m
k a r n oː s ʊ m	k a r n oː s ʊ m
ɪ s p ɛ k t j oː n aː m	iː n s p ɛ k t aː r ɛ
r uː g iː r ɛ	r uː g iː r ɛ
s a l a k ɛ	s a l aː k ɛ m
ɪ m p ɛ t j ɛ r ɛ	ɪ m p ɛ d iː r ɛ
t ɛ s ʊ r a m	t eː n s uː r a m
ɪ m p r ɛ k aː r ɛ	ɪ m p r ɛ k aː r iː
g ɔ d ɛ r ɛ	g aʊ d eː r ɛ
w ɪ t ɛ lː ʊ m	w ɪ t ɛ lː ʊ m
s kʷ aː l ʊ m	s kʷ aː l ʊ m
s ɛ l w aː t ɪ k	s ɪ l w aː t ɪ k ʊ m
a s k ɛ n s j oː n ɛ m	a s k eː n s j oː n ɛ m
a dː ɪ k t ʊ m	a dː ɪ k t ʊ m
t r iː t ɛ n aː r j ʊ m	t r iː k eː n aː r j ʊ m
k ɔ n t ɪ n w aː t j oː n ɛ m	k ɔ n t ɪ n w aː t j oː n ɛ m
ɪ m p ʊ l s j oː n ɛ m	ɪ m p ʊ l s j oː n ɛ m
k ɔ m p ɪ aː k ɛ r ɛ	k ɔ m p l a k eː r ɛ
f a b ʊ r ɪ k aː t j oː n ɛ m	f aː b r ɪ k aː t j oː n ɛ m
f a b ɛ lː a m	f aː b ɛ lː a m
w ɔ ɪ s	w oː s
aʊ r iː r ɛ	h aʊ r iː r ɛ
r uː p ɛ m	r uː p ɛ m
s ʊ s t aɪ n t aː r ɛ	s ʊ s t ɛ n t aː r ɛ
f ɪ l j aː l ɛ	f iː l j aː l ɛ m
d eː k ɔ r aː r ɛ	d ɛ k ɔ r aː r ɛ
k ɛ n aː k ɪ l ʊ m	k eː n aː k ʊ l ʊ m
n a rː aː r ɛ	n a rː aː r ɛ
ɪ n f l aː m aː t j oː n ɛ m	iː n f l a mː aː t j oː n ɛ m
kʷ aː s k aː r ɛ	kʷ a sː aː r ɛ
ɔ b s ɛ kʷ j ʊ m	ɔ b s ɛ kʷ j ʊ m
p r aɪ d aː t j uː n ɛ m	p r aɪ d aː t j oː n ɛ m
b a g a m	b aː k a m
k a n iː k ʊ l a m	k a n iː k ʊ l a m
m a n k ɪ p m j ʊ m	m a ŋ k ɪ p j ʊ m
t ɛ n ɪ ʊ ɛ	t ɛ n ʊ ɛ m
b l ɛ tʰ ʊ m	b l ɪ t ʊ m
p eː kʰ aː r ɛ	p ɛ kː aː r ɛ
ɛ k s a s p ɛ r aː t j oː n ɛ m	ɛ k s a s p ɛ r aː t j oː n ɛ m
s t ʊ l t ʊ m	s t ʊ l t ʊ m
ɔ n a g r ʊ m	ɔ n a g r ʊ m
l ɛ n a d oː r ɛ	l ɪ ŋ n aː t oː r ɛ m
s ʊ s p ɛ n s j oː n ɛ m	s ʊ s p eː n s j oː n ɛ m
d eː f l ʊ ɪ r ɛ	d eː f l ʊ ɛ r ɛ
p a l p ɛ b r aː l ɛ m	p a l p ɛ b r aː l ɛ m
s t ʊ d j ʊ m	s t ʊ d j ʊ m
l ɪ n ɛ aː m ɛ n aː ʊ m	l iː n ɛ aː m ɛ n t ʊ m
eː r g aː s t ʊ l ʊ m	ɛ r g a s t ʊ l ʊ m
ɪ rː h ɔ m p ɛ r ɛ	ɪ rː ʊ m p ɛ r ɛ
a b n ʊ ɪ r ɛ	a b n ʊ ɛ r ɛ
d eː k ɔ rː ɛ r j ɛ	d eː k ʊ rː ɛ r ɛ
p ɪ ŋ gʷ	p ɪ ŋ gʷ ɛ m
k ɔ n g ʊ r aː t j oː n ɛ m	k ɔ n ɪ uː r aː t j oː n ɛ m
a gː r ɛ d ɛ r ɛ	a gː r ɛ d iː
d eː s ʊ l t oː r j ʊ m	d eː s ʊ l t oː r j ʊ m
p ɛ r s ɛ k uː t oː r ɛ m	p ɛ r s ɛ k uː t oː r ɛ m
k ɔ r n j uː ʊ m	k ɔ r n ɛu m
d ɛ m a n d aː r ɛ	d eː m a n d aː r ɛ
s a k k j oː n ɛ m	s aː ŋ k t j oː n ɛ m
r a k ɛ m oː s ʊ m	r a k eː m oː s ʊ m
s t a b ɪ l ɛ r ɛ	s t a b ɪ l iː r ɛ
aʊ s p ɛ d aː r ɛ	h ɔ s p ɪ t aː r iː
j ɛ l aː r ɛ	g ɛ l aː r ɛ
p r aɪ ɔ k ʊ p aː r ɛ	p r aɪ ɔ kː ʊ p aː r ɛ
f ʊ l g ʊ r aː r ɛ	f ʊ l g ʊ r aː r ɛ
k r ɛ a t r ɪ k ɛ	k r ɛ aː t r iː k ɛ m
w r iː n k ʊ l ʊ m	w ɪ ŋ k ʊ l ʊ m
uː m b r aː t ɪ k ʊ m	ʊ m b r aː t ɪ k ʊ m
k ɔ n s a ŋ gʷ ɪ n ɪ t aː t ɛ m	k oː n s a ŋ gʷ ɪ n ɪ t aː t ɛ m
b ɛ r iː lː ʊ m	b eː r y lː ʊ m
p r ɛ s ɛ ŋ t ɪ r ɛ	p r aɪ s ɛ n t iː r ɛ
f ɔ r n ɪ k aː t oː r ɛ m	f ɔ r n ɪ k aː t oː r ɛ m
s ɛ n s aː t j oː n ɛ m	s eː n s aː t j oː n ɛ m
m a l d ɪ h t j oː n ɛ m	m a l ɛ d ɪ k t j oː n ɛ m
f uː ŋ g oː s ʊ m	f ʊ ŋ g oː s ʊ m
ɪ n k ɔ n k uː sː ʊ m	ɪ ŋ k ɔ ŋ k ʊ sː ʊ m
w ɛ r iː f iː k aː r ɛ	w eː r ɪ f ɪ k aː r ɛ
f r aː t ɛ r n ʊ m	f r aː t ɛ r n ʊ m
t a l aː m ʊ m	tʰ a l a m ʊ m
k eː r t aː r ɛ	k ɛ r t aː r ɛ
p ɛ l aː k ʊ m	p ɛ l a g ʊ s
f aɪ b ʊ l ɛ m	f l eː b ɪ l ɛ m
a b ɔ m ɪ n aː r ɛ	a b oː m ɪ n aː r iː
s uː m	s ʊ ɛ m
s a g ɪ t aː r j ʊ m	s a g ɪ tː aː r j ʊ m
p uː p iː lː ʊ m	p uː p ɪ lː ʊ m
d ɪ s ɛ r t ʊ m	d ɪ s ɛ r t ʊ m
k ɔ m p aː r eː t r ɛ m	k ɔ m p aː r eː r ɛ
w ɪ b r aː r ɛ	w ɪ b r aː r ɛ
a n ɛ m ɔ n ɛ	a n ɛ m oː n eː n
a d ɔ l ɛ t ɛ n t j a m	a d ʊ l eː s k ɛ n t j a m
w ɪ lː aː n ʊ m	w iː lː aː n ʊ m
w ɛ t ʊ s t ʊ m	w ɛ t ʊ s t ʊ m
ɔ m ɛ n t ʊ m	oː m ɛ n t ʊ m
tʰ j ɔ	tʰ iː ʊ m
w ɪ n k ʊ l aː r ɛ	w ɪ ŋ k ʊ l aː r ɛ
s a t ʊ r aː r ɛ	s a t ʊ r aː r ɛ
f r ɔ n t aː l ɛ	f r ɔ n t aː l ɛ m
t r ɛ m ʊ l ʊ m	t r ɛ m ʊ l ʊ m
a sː aː t aː r ɛ	a sː ɛ k t aː r iː
p ɛ r a k ɪ r ɪ r ɛ	p ɛ r kʷ iː r ɛ r ɛ
s ɔ l aː r ɛ	s oː l aː r ɛ m
t ɪ m oː n ɛ	t eː m oː n ɛ m
p ɛ r p eː t w aː t j oː n ɛ m	p ɛ r p ɛ t w aː t oː n ɛ m
ɪ m p j ʊ m	ɪ m p j ʊ m
w ɛ n j a m	w ɛ n j a m
l ɪ iː m aː t ɛ m	l iː m aː k ɛ m
d ɛ k s t eː r ɪ t aː t ɛ m	d ɛ k s t ɛ r ɪ t aː t ɛ m
k a s t aː n j a m	k a s t a n ɛ a m
k ɔ n m ɔ ɛ w ɛ r ɛ	k ɔ mː ɔ w eː r ɛ
