uː n iː f ɔ r m ɛ m	uː n ɪ f oː r m ɛ m
p r ɛ w j ʊ m	p r aɪ w j ʊ m
ɔ f iː k iː n a m	ɔ fː ɪ k iː n a m
g uː b a m	j ʊ b a m
k ɔ m p ʊ n k t j ʊ n ɛ m	k ɔ m p ʊ ŋ k t j oː n ɛ m
k iː n ɛ n t ɔ s	kʷ iː ŋ g ɛ n t oː s
l ʊ t r d ʊ m	l uː r ɪ d ʊ m
p ɔ ɛ r iː l ɛ	p ʊ ɛ r iː l ɛ m
k uː l t ʊ m	k ʊ l t ʊ m
n ɛ g aː r ɛ	n ɛ g aː r ɛ
p ʊ l w ɛ r iː zː aː r ɛ	p ʊ l w ɛ r iː zː aː r ɛ
g aː r ɪ f ʊ m	g r a pʰ j ʊ m
s a l w aː r ɛ	s a l w aː r ɛ
m ɛ r g ɛ r ɛ	m ɛ r g ɛ r ɛ
s a p oː r ɛ m	s a p oː r ɛ m
s aː t iː r ʊ m	s a t y r ʊ m
p j ɛ r s ɪ k a m	p ɛ r s ɪ k a m
s k iː m j a m	s iː m j a m
s eː r aː f iː k ʊ m	s ɛ r a pʰ ɪ k ʊ m
k ɔ n w ɛ k s ʊ m	k ɔ n w ɛ k s ʊ m
k a l k ʊ l ʊ m	k a l k ʊ l ʊ m
p a l uː d ɛ m	p a l uː d ɛ m
s uː p ɛ r ɪ w a k aː n ɛ ʊ m	s ʊ p ɛ r w a k ʊː m
k a l k ɛ m	k a l k ɛ m
a d ʊ n aː r ɛ	a d uː n aː r ɛ
l a b oː r	l a b oː r ɛ m
p l uː m a m	p l uː m a m
f iː k t j oː n ɛ m	f ɪ k t j oː n ɛ m
w ɪ n d ɪ m j a m	w iː n d eː m j a m
n ɛ kʷ ɛ t a r ɛ	n ɛ k t a r
a k uː s aː b eː l ɛ	a kː uː s aː b ɪ l ɛ m
kʷ ɛ s t j oː n ɛ m	kʷ aɪ s t j oː n ɛ m
a f l iː g ɛ r ɛ	a fː l iː g ɛ r ɛ
p ɛ n s iː l ɛ	p eː n s ɪ l ɛ m
r eː w ʊ l w eː r ɛ	r ɛ w ɔ l w ɛ r ɛ
k ɔ d a m	k aʊ d a m
t iː t ʊ l aː r ɛ	t ɪ t ʊ l aː r ɛ m
a b ɔ rː ɪ r ɛ	a b h ɔ rː eː r ɛ
s t uː p r ʊ m	s t ʊ p r ʊ m
r j aː t ʊ m	r ɛ aː t ʊ m
a p ɛ n d ɛ r ɛ	a pː ɛ n d ɛ r ɛ
k ʊ n t ɔ r k eː r ɛ	k ɔ n t ɔ r kʷ eː r ɛ
k a p ɪ t ɛ lː ʊ m	k a p ɪ t ɛ lː ʊ m
m ʊ l iː n ʊ m	m ɔ l iː n ʊ m
rː d r ɛ iː k n	r ɪ d ɪ k a m
w ɛ s t r uː k ɛ m ʊ	s t r uː tʰ j oː n ɛ m
p ɛ r s ɛ k uː t oː r ɛ	p ɛ r s ɛ k uː t oː r ɛ m
w iː n oː s ʊ m	w iː n oː s ʊ m
aː k t ʊ m	aː k t ʊ m
ɛ k s ɛ k r aː r ɛ	ɛ k sː ɛ k r aː r iː
s p ɛ k ʊ j ʊ m	s p ɛ k l ʊ m
f iː g uː r a m	f ɪ g uː r a m
iː n k l iː t ʊ m	ɪ ŋ k l ɪ t ʊ m
r aː p ʊ m	r aː p ʊ m
l ʊ k ɛ lː ʊ m	l ɔ k ɛ lː ʊ m
b ɪ s pʰ m a m	b eː s t j a m
ɔ k l uː d ɛ r ɛ	ɔ kː l uː d ɛ r ɛ
g r a m iː n ɛ ʊ m	g r aː m ɪ n ɛu m
m iː l iː t ɛ m	m iː l ɪ t ɛ m
s a l w ʊ m	s a l w ʊ m
aː s	a sː ɛ m
p r eː t iː p iː t j ʊ m	p r aɪ k ɪ p ɪ t j ʊ m
p iː n t ʊ m	p ɪ k t ʊ m
f l uː iː r ɛ	f l ʊ ɛ r ɛ
r aː s ɛ k aː r ɛ	r ɛ s ɛ k aː r ɛ
r aː m ʊ m	r aː m ʊ m
aʊ g uː r aː r ɛ	aʊ g ʊ r aː r ɛ
p eː r iː k ʊ l oː s ʊ m	p ɛ r iː k ʊ l oː s ʊ m
k ɔ m p r iː m ɛ r ɛ	k ɔ m p r ɪ m ɛ r ɛ
p uː j a r ɛ	p ʊ t eː r ɛ
w a r oː n	w aː r oː n ɛ m
p h eː p ɛ m r	p ɪ p ɛ r
ɛ kʷ iː w ʊ k a r ɛ	aɪ kʷ ɪ w ɔ k aː r ɛ
f r a t ɛ r n ʊ m	f r aː t ɛ r n ʊ m
iː n d iː g ɛ n t j a	ɪ n d ɪ g ɛ n t j a m
l uː k j ʊ m	l uː k j ʊ m
f a s t ɪ d j oː s ʊ m	f a s t iː d j oː s ʊ m
p uː lː uː l aː r ɛ	p ʊ lː ʊ l aː r ɛ
p r oː ʊ a	p r oː r a m
k ɔ n k ʊ r s ʊ m	k ɔ ŋ k ʊ r s ʊ m
m ɔ d ɪ r	m ɔ l ɛ r ɛ
s k r uː p uː l oː s ʊ m	s k r uː p ʊ l oː s ʊ m
r ɛ p ɛ r k uː s j oː n ɛ m	r ɛ p ɛ r k ʊ t ɛ r ɛ
ɔ w ɪ l a m	ɔ w ɪ k ʊ l a m
p ɛ r f iː d ʊ m	p ɛ r f ɪ d ʊ m
g oː l a m	g ʊ l a m
iː m p r ʊ b aː r	ɪ m p r ɔ b aː r ɛ
f r ɪ g ʊ m m	f r iː g ɪ d ʊ m
kʷ ɪ t a n t j a	kʷ ɪ eː t a n t j a m
s t r aː t ʊ m	s t r aː t ʊ m
iː m s t r uː iː r ɛ	iː n s t r ʊ ɛ r ɛ
k ɪ l ʊ m	k ɪ l j ʊ m
l ɛ t iː t j a m m	l aɪ t ɪ t j a m
s uː b l iː m a t j oː n ɛ m	s ʊ b l iː m aː t j oː n ɛ m
a p r ɔ p r j a t j oː n ɛ m	a pː r ɔ p r j aː t j oː n ɛ m
p ɛ r k ɔ l a t j ʊ n ɛ m	p ɛ r k oː l aː t j oː n ɛ m
t r a n s uː b s t a n t j aː r ɛ	t r aː n s ʊ b s t a n t j aː r ɛ
k ɔ t ɛ m m	k oː t ɛ m
aʊ r ɔ r a m	aʊ r oː r a m
a k r iː t uː d ɛ m	aː k r ɪ t uː d ɪ n ɛ m
t ɛ d uː lː a m	s kʰ ɛ d ʊ l a m
d eː s ɪ ŋ k a t j oː n ɛ m	d eː s ɪ kː aː t j oː n ɛ m
g ɛ r m ɛ m n	g ɛ r m ɛ n
s ʊ l iː d aː r ɛ	s ɔ l ɪ d aː r ɛ
l iː t ɛ m	l iː t ɛ m
a n h eː k aː r ɛ	n ɛ k aː r ɛ
p l a ɛ m n ɛ r ɛ	p l a ŋ g ɛ r ɛ
f eː rː aː t ʊ m	f ɛ rː aː t ʊ m
f ʊ r n aː k ɛ m	f ɔ r n aː k ɛ m
d eː l ɛ k t a t j oː n ɛ m	d eː l ɛ k t aː t j oː n ɛ m
m a n s ʊ ɛ t uː m d ɪ n ɛ m	m aː n s ʊ eː t uː d ɪ n ɛ m
uː m iː l j aː r ɛ	h ʊ m ɪ l j aː r ɛ
r ɪ s ʊ m	r iː s ʊ m
k a w iː lː aː r ɛ	k a w ɪ lː aː r iː
k r uː ɛ n t ʊ m	k r ʊ ɛ n t ʊ m
r uː f ʊ m	r uː f ʊ m
d iː f lː uː ɛ r	d ɪ fː l ʊ ɛ r ɛ
d uː b ɪ ʊ m	d ʊ b j ʊ m
b iː b l j ɛ ɔ t ɛ k aː r j ʊ m	b ɪ b l ɪ ɔ tʰ eː k aː r j ʊ m
k f ɪ w ɔ l ʊ m	f iː l ɪ ɔ l ʊ m
g aː d ɛ m	iː l ɛ
d ɛ t ɛ r m iː n aː r ɛ	d eː t ɛ r m ɪ n aː r ɛ
d ʊ ɛ k ɛ n t ɔ s	d ʊ k ɛ n t oː s
aː n w ʊ m	a nː ʊː m
w ʊ l h ɛ r ɛ	w ɛ lː ɛ
ɪ n w ɛ s t ɪ r ɛ	ɪ n w ɛ s t iː r ɛ
p a k iː f iː k a t j oː n ɛ	p aː k ɪ f ɪ k aː t j oː n ɛ m
b aː a t ʊ m	b ɔ aː t ʊ m
s p oː s a m	s p oː n s a m
r ɛ k l iː n aː r ɛ	r ɛ k l iː n aː r ɛ
k ɛ m	kʷ ɪ s
aʊ r iː k ʊ l a m	aʊ r ɪ k ʊ l a m
k iː r k ʊ n l ʊ k uː t j ʊ n ɛ	k ɪ r k ʊ m l ɔ k uː t j oː n ɛ m
b ɛ n ɛ f iː k ʊ m	b ɛ n ɛ f ɪ k j ʊ m
iː ŋ n a r ʊ m	ɪ ŋ n aː r ʊ m
p l ʊ m b a t ɪ k iː n ɛ m	p l ʊ m b aː g ɪ n ɛ m
k ʊ m m ʊ w eː r ɛ	k ɔ mː ɔ w eː r ɛ
l iː m a m	l iː m a m
ɛ k s a l aː r ɛ	ɛ k s h aː l aː r ɛ
t ʊ r p ɛ d ʊ m	t ɔ r p eː d ɪ n ɛ m
k ʊ n k a t ɛ n a r ɛ	k ɔ ŋ k a t eː n aː r ɛ
p ɔ l ʊ m	p ɔ l ʊ m
p ɔ lː uː ɛ r	p ɔ lː ʊ ɛ r ɛ
iː m p r	ɪ m p a r ɛ m
b iː l ɛ m	b iː l ɛ m
g ʊ s t ʊ m	g ʊ s t ʊ m
k ʊ m p ɛ lː ɛ r	k ɔ m p ɛ lː ɛ r ɛ
rː iː k t ʊ m	r ɪ k t ʊ m
n ɔ nː a	n ɔ nː a m
a f ɪ r m aː r ɛ	a fː ɪ r m aː r ɛ
p r a n ɛ r ɛ m	p r a n d eː r ɛ
w ɛ r m eː l ʊ m	w ɛ r m ɪ k ʊ l ʊ m
s ʊ lː ɛ w aː r ɛ	s ʊ b l ɛ w aː r ɛ
b j aː t ʊ m	b ɛ aː t ʊ m
b aː r a t r ʊ m	b a r a tʰ r ʊ m
k ɔ n s k ɛ ʊ m	k oː n s k j ʊ m
f ʊ l d ɪ r ɛ	f ʊ l g ʊ r
a w eː s ʊ m	aː w ɛ r s ʊ m
m eː l ʊ m	m aː l ʊ m
ʊ k ɪ d eː r ɛ	ɔ kː ɪ d ɛ r ɛ
lː ɔ k a m	l uː t ɛu m
ɪ n k eː n d ɛ r ɛ	ɪ ŋ k ɛ n d ɛ r ɛ
l ɛ ɔ p a r d ʊ m	l ɛ ɔ p a r d ʊ m
k ɔ n w ɔ k aː r ɛ	k ɔ n w ɔ k aː r ɛ
kʷ ɛ r ɛ l a m	kʷ ɛ r eː l a m
f ʊ ŋ g oː s ʊ m	f ʊ ŋ g oː s ʊ m
d ɛ r ɔ m p ɛ r ɛ	d iː r ʊ m p ɛ r ɛ
p r ɔ r ɔ g aː r ɛ	p r oː r ɔ g aː r ɛ
s ɛ kʷ aː k ɛ	s ɛ kʷ aː k ɛ m
w ʊ l t ʊ m	w ʊ l t ʊ m
d iː s k ʊ rː ɛ r ɛ	d ɪ s k ʊ rː ɛ r ɛ
n aː s ʊ m	n aː s ʊ m
p r iː m ʊ g ɛ n iː t ʊ m	p r iː m oː g ɛ n ɪ t ʊ m
m eː r ɛ n d a m	m ɛ r ɛ n d a m
n a w iː fː ʊ m	n aː w ɪ g j ʊ m
g ɛ ɔ g r a f j ɪ a m	g eː ɔ g r a pʰ j a m
iː n d ɛ f iː n iː t ʊ m	ɪ n d eː f iː n iː t ʊ m
l a p iː d a t j ʊ n ɛ m	l a p ɪ d aː t j oː n ɛ m
ɪ m p ɛ t r aː r ɛ	ɪ m p ɛ t r aː r ɛ
f r a ŋ g ɪ r ɛ m	f r a ŋ g ɛ r ɛ
b ʊ m b aː r d a m	b ɔ m b a r d a m
k ʊ l m ʊ m	k ʊ l m ʊ m
m a n iː p ʊ l ʊ m	m a n ɪ p ʊ l ʊ m
ɔ r iː g ɪ n ɛ m	ɔ r iː g ɪ n ɛ m
ɛ s t ʊ m	aɪ s t aː t ɛ m
p r aː n d z ʊ m	p r a n d j ʊ m
k a w a l ɪ ɛ r	k a b a lː aː r j ʊ m
ɛ m s iː t ʊ m	ɛ k s ɪ t ʊ m
k ɔ l uː b r iː n ʊ m	k ɔ l ʊ b r iː n ʊ m
d ɛ k ɛ p t ɔ r j ʊ m	d ɛ k ɛ p t oː r j ʊ m
m ɔ d ɛ r a t oː r ɛ	m ɔ d ɛ r aː t oː r ɛ m
s ʊ ɛ n ʊ	s ɔ n ʊ m
s t aː t ʊ m	s t a t ʊ m
k ʊ k iː n aː r ɛ	k ɔ kʷ iː n aː r ɛ
k aː t ɛ d r a m	k a tʰ ɛ d r a m
k ʊ k iː n a m	k ɔ kʷ iː n a m
p ɛ n d ɛ r ɛ	p ɛ n d eː r ɛ
s ɛ n ɛ m	s ɛ n ɛ m
p eː lː aː r ʊ m	p ɛ lː aː r j ʊ m
s ʊ m ʊ m	s ʊ mː ʊ m
w ɛ r t iː g iː n oː s ʊ m	w ɛ r t iː g ɪ n oː s ʊ m
iː n s iː ŋ n ɛ m	iː n s ɪ ŋ n ɛ m
k ʊ l ɛ k j ʊ m	k aʊ l ɪ k ʊ l ʊ m
a t k ʊ ɛ r j iː r ɛ	a kː w iː r ɛ r ɛ
s t a t ʊ ɛ r ɛ	s t a t ʊ ɛ r ɛ
t ɛ r ɛ b r a m	t ɛ r ɛ b r a m
kʷ a l iː f iː k aː r ɛ	kʷ aː l ɪ f ɪ k aː r ɛ
eː s ʊ m	ɪ p s ʊ m
k a d aː w ɛ r ɛ	k a d aː w ɛ r
l iː b iː d ʊ m	l ɪ b iː d ɪ n ɛ m
g r iː f ʊ m	g r y pʰ ɛ m
k ɔ n k l a m a r ɛ	k ɔ ŋ k l aː m aː r ɛ
t a n t ʊ m	t a n t ʊ m
aː g a t a m	a kʰ aː t eː n
m eː r iː t ɔ r j ʊ m	m ɛ r ɪ t oː r j ʊ m
p r ɛ m w ɛ r n ɛ m	w eː r
iː n k iː d ɪ r ɛ	ɪ ŋ k ɪ d ɛ r ɛ
b ʊ k ɪ n ɛ	b uː k ɪ n ʊ m
g r a t aː g ɪ t ʊ m	g r aː t ʊ iː t ʊ m
r ɛ k ɔ n k iː l j a t j oː n ɛ m	r ɛ k ɔ ŋ k ɪ l j aː t j oː n ɛ m
a b r iː k ʊ m	a p r iː k ʊ m
k r ʊ s t m oː s ʊ m	k r ʊ s t oː s ʊ m
s ɔ n a m	z oː n a m
ɔ k uː l aː r ɛ	ɔ k ʊ l aː r ɛ m
a l t ɛ r k a t j oː n ɛ m	a l t ɛ r k aː t j oː n ɛ m
d ɪ f ɪ aː m aː r ɛ	d ɪ fː aː m aː r ɛ
ɪ p ɛ fː l a m	a p ɪ k ʊ l a m
s t r iː g iː l ɛ	s t r ɪ g ɪ l ɛ m
uː m ɪ d ʊ m	h uː m ɪ d ʊ m
d ɛ n ɔ m iː n aː r ɛ	d eː n oː m ɪ n aː r ɛ
p r uː d ɪ r ɛ	p r uː r iː r ɛ
t eː m ɛ r iː t aː t ɛ m	t ɛ m ɛ r ɪ t aː t ɛ m
d ɔ m ɪ n j ʊ m	d ɔ m ɪ n j ʊ m
t j ɪ p ɛ ɪ d ʊ m	t ɛ p ɪ d ʊ m
p a g a n iː s m ʊ m	p aː g aː n ɪ s m ʊ m
b r ɔ k ʊ m	b r ɔ kː ʊ m
f uː r t ʊ m	f uː r t ʊ m
ɛ k s a k ɛ r b a t j oː n ɛ m	ɛ k s a k ɛ r b aː t j oː n ɛ m
a k s k ɛ sː oː r j ʊ m	a kː ɛ sː oː r j ʊ m
rː j ɛ aː g iː r	r ɛ a g eː r ɛ
p eː n uː r j a m	p eː n uː r j a m
t eː m ɔ r ɛ m	t ɪ m oː r ɛ m
s ʊ s p iː r j aː r ɛ	s ʊ s p iː r aː r ɛ
f ɪ l ʊ	f l ʊ k t ʊ m
f uː n ɛ s t ʊ m	f uː n ɛ s t ʊ m
k ɔ m ɛ r k j a l ɛ	k ɔ mː ɛ r k j aː l ɛ m
m a l f aː r ɛ	m a l ɛ f a k ɛ r ɛ
l a k r iː m oː s ʊ m	l a k r ɪ m oː s ʊ m
b eː r iː lː ʊ m	b eː r y lː ʊ m
n a t r iː k ɛ	n aː t r iː k ɛ m
d ɪ r h aː t uː r a m	d iː r ɛ k t uː r a m
l a k aː r a	l a sː aː r ɛ
iː n t ʊ iː r ɛ	ɪ n t ʊ eː r iː
l iː t iː g aː r ɛ	l iː t ɪ g aː r ɛ
k a d uː k ʊ m	k a d uː k ʊ m
k l a r iː t aː t ɛ m	k l aː r ɪ t aː t ɛ m
s ʊ n ɪ t ʊ m	s ɔ n ɪ t ʊ m
k a l h eː r ɛ	k a l eː r ɛ
p r ɔ s ɛ n j ɔ m	p r ɔ s k eː n j ʊ m
d ɛ k ɛ p t iː w ʊ	d ɛ k ɛ p t iː w ʊ m
a ŋ g ɔ s t aː r ɛ	a ŋ g ʊ s t aː r ɛ
w ɛ g ɛ t ʊ m	w ɛ g ɛ t ʊ m
a p a r h iː r ɛ	a pː aː r eː r ɛ
s t r ɪ ŋ g ɛ r ɛ	s t r ɪ ŋ g ɛ r ɛ
a l ɔ s a	a l aʊ s a m
b ɛ t r iː k ɛ m	w iː t ɪ k ɛ m
k eː f a l pʰ a m	k ɛ pʰ a l aɪ a m
s eː p ʊ l t uː r a m	s ɛ p ʊ l t uː r a m
l a b ɔ r a t h oː r j ʊ m	l a b oː r aː t oː r j ʊ m
w a r z a m	w ɪ r ɪ d ɛ m
ɔ k k iː d ɛ n t ɛ m	ɔ kː ɪ d ɛ n t ɛ m
k a t a r a kʷ ɛ t a	k a t a r a k t a m
k ɔ n f ɔ r m ɛ m	k oː n f oː r m ɛ m
k ɔ n f l uː ɛ r ɛ	k oː n f l ʊ ɛ r ɛ
k ʊ lː uː d ɪ r ɛ	k ɔ lː uː d ɛ r ɛ
k uː r a m	k uː r a m
s p ɛ k ʊ m	s p ɛ k ʊ l ʊ m
d eː s p ɛ t aː r ɛ	d eː s p ɛ k t aː r ɛ
w iː s ʊ m m	w iː s ʊ m
b aː s j ʊ m	b aː s j ʊ m
d iː k aː k ɛ	d ɪ k aː k ɛ m
r ɛ s t aʊ r a t j oː n ɛ m	r eː s t aʊ r aː t j oː n ɛ m
f a k ɛ s j ʊ m	f a k eː t ʊ m
g a l ɛ r ʊ m	g a l eː r ʊ m
k ɪ p a m	k aɪ p a m
b ʊ l p ɛ m	w ʊ l p ɛ m
a t lː aː n t iː k ʊ m	aː t l a n t ɪ k ʊ m
n aʊ s ɪ aː b ʊ n d ʊ m	n aʊ s ɛ aː b ʊ n d ʊ m
r ɛ f l ɔ r ɪ r ɛ	r ɛ f l oː r eː r ɛ
m ɔ n ɛ t a m	m ɔ n eː t a m
ɛ b ɛ t ɛ	h ɛ b ɛ t ɛ m
a r k aː n ʊ m	a r k a n ʊ m
a n ɛ l aː r ɛ	a n h eː l aː r ɛ
d oː n ʊ s t aː r	d ɛ h ɔ n ɛ s t aː r ɛ
l iː m ʊ m	l iː m ʊ m
a s t ʊ r ɛ	a s t ʊ r ɛ m
s ɛ w ɛ r ʊ m	s ɛ w eː r ʊ m
g uː s t iː f iː k a t ʊ r ɛ	j uː s t ɪ f ɪ k aː t oː r ɛ m
m ɛ l ɔ r a r ɛ	m ɛ l j oː r aː r ɛ
s t r iː g ɛ m	s t r ɪ g ɛ m
g uː r iː s p r uː d ɛ n t j a	j uː r ɪ s p r uː d ɛ n t j a m
m ɛ s t ʊ m	m aɪ s t ʊ m
rː aː p t ʊ m	r a p t ʊ m
ɛ lː uː ɛ r ɛ	eː l ʊ ɛ r ɛ
f a l a ŋ g ɛ m	pʰ a l a ŋ g ɛ m
d ɔ r m iː t h oː r j ʊ m	d ɔ r m iː t oː r j ʊ m
f ɛ n d ɛ r ɛ	f ɪ n d ɛ r ɛ
f aʊ s t ʊ m	f aʊ s t ʊ m
s a lː a t iː t aː t ɛ m	s a l aː k ɪ t aː t ɛ m
a b r ɛ w j aː r ɛ	a bː r ɛ w j aː r ɛ
n a rː a t j oː n	n aː rː aː t ʊ m
ɔ r ɪ g a n ʊ m	ɔ r iː g a n ʊ m
p r ɛ m ʊ n iː t ʊ r ɛ m	p r aɪ m ɔ n ɪ t oː r ɛ m
iː f ɪ m a r ɛ	ɪ f ɪ k aː r ɛ
eː k ʊ m s ɪ k aː r ɛ	ɛ k sː ɪ kː aː r ɛ
p a l aː r j ɛ m	p a l ɛ aː r j ʊ m
s t uː d j ʊ m	s t ʊ d j ʊ m
s a k r iː l ɛ g ʊ m	s a k r ɪ l ɛ g ʊ m
k eː l ɛ s t j a l ɛ	k aɪ l ɛ s t j aː l ɛ m
m aː s a m	m a sː a m
iː n f l uː ɛ r ɛ	iː n f l ʊ ɛ r ɛ
m ɛ r ʊ m	m ɛ r ʊ m
d eː m ɛ n t ɪ k a r ɛ	d eː m ɛ n t aː r ɛ
l uː b r ɪ k aː r ɛ	l uː b r ɪ k aː r ɛ
iː n s uː l s ʊ m	iː n s ʊ l s ʊ m
a b s uː r d iː t aː t ɛ m	a b s ʊ r d ɪ t aː t ɛ m
iː m f lː iː g ɛ r ɛ	iː n f l iː g ɛ r ɛ
s ɔ l iː d ʊ m	s ɔ l ɪ d ʊ m
t iː s iː k ʊ m	p eː h tʰ ɪ s ɪ k ʊ m
b ɛ lː ʊ m	b ɛ lː ʊ m
p r ɔ f uː g ʊ m	p r ɔ f ʊ g ʊ m
iː ŋ d iː t j ʊ m	ɪ n d ɪ k j ʊ m
k lː aʊ s uː lː a m	k l aʊ s ʊ l a m
r eː k ɛ s iː w ʊ m	r ɛ k ɛ sː iː w ʊ m
iː m mː ɔ l aː r ɛ	ɪ mː ɔ l aː r ɛ
k uː r w aː r ɛ	k ʊ r w aː r ɛ
n aʊ f r a g ʊ m	n aʊ f r a g ʊ m
n a t iː w iː t aː t ɛ m	n aː t iː w ɪ t aː t ɛ m
t ɛ rː ɛ ʊ m	t ɛ rː ɛu m
l a m ɛ n t aː r ɛ	l aː m ɛ n t aː r ɛ
ɪ b ɪ l ɛ	ɪ b ɪ l ɛ m
g l ʊ r j a r ɛ	g l oː r j aː r iː
p a l uː d oː s ʊ m	p a l uː d oː s ʊ m
kʷ iː n kʷ ɛ n a l ɛ	kʷ iː ŋ kʷ ɛ nː aː l ɛ m
iː n kʷ iː l iː n ʊ m	ɪ ŋ kʷ ɪ l iː n ʊ m
n a lː ɪ k a m	n a t ɛ m
p eː r iː k l iː t aː r ɛ	p ɛ r iː k l ɪ t aː r iː
r ɛ p uː ŋ n aː r ɛ	r ɛ p ʊ ŋ n aː r ɛ
a b s t ɛ r g eː r ɛ	a b s t ɛ r g eː r ɛ
aː b r ʊ g a k oː n	a b r ɔ g aː t j oː n ɛ m
p r ɛ m iː k a s	p r iː m ɪ t j a m
p r ɔ b ʊ m	p r ɔ b ʊ m
t ɪ l j ʊ m	t ɪ l j a m
s a n t ʊ r j ɛ t a	s a t ʊ r eː j a m
k iː n d ɛ l a	k a n d eː l a m
eː m ɔ l uː m ɛ n t ʊ m	eː m ɔ l ʊ m ɛ n t ʊ m
n a w ɪ k ɛ lː a	n aː w ɪ k ɛ lː a m
r ɛ f ɔ r m aː r ɛ	r ɛ f oː r m aː r ɛ
ɛ k s t ɛ r m iː n a t j oː n	ɛ k s t ɛ r m ɪ n aː t j oː n ɛ m
t ɛ rː eː n ʊ m	t ɛ rː eː n ʊ m
t ɛ r m iː t ɛ m	t a r m ɪ t ɛ m
ɔ n aː g r ʊ m	ɔ n a g r ʊ m
j ɛ pʰ k n a m a m	iː l ɪ k ɛ m
d eː m ɔ m s t r a t j oː n ɛ m	d eː m oː n s t r aː t j oː n ɛ m
k aː n d iː d ʊ m	k a n d ɪ d ʊ m
p r ɛ s ɛ n t iː r	p r aɪ s ɛ n t iː r ɛ
s eː r w iː t ʊ t ɛ m	s ɛ r w ɪ t uː t ɛ m
d ʊ kː aː	d ʊ k t j oː n ɛ m
a m b aː g ɛ s	a m b aː g ɛ m
f a rː a g ɪ n ɛ	f a rː aː g ɪ n ɛ m
k iː r k ʊ l aː r ɛ	k ɪ r k ʊ l aː r ɛ m
ɪ h s ʊ g aː r ɛ	ɛ k sː uː k aː r ɛ
iː m b ɔ s	a m b oː s
ɔ s t ɛ n s iː w ʊ	ɔ s t eː n s iː w ʊ m
m uː g ɪ r ɛ	m uː g iː r ɛ
f ɪ d aː r ɛ	f iː d ɛ r ɛ
f ʊ n d a t oː r ɛ	f ʊ n d aː t oː r ɛ m
rː uː g oː m ʊ m	r uː g oː s ʊ m
t ʊ r m ɛ n t ʊ m	t ɔ r m ɛ n t ʊ m
iː m p uː l s iː w ʊ m	ɪ m p ʊ l s iː w ʊ m
r eː w ɔ k aː r ɛ	r ɛ w ɔ k aː r ɛ
a k ɛ f a lː ʊ m	a k ɛ pʰ a l ʊ m
eː m uː l a t ɔ r ɛ	aɪ m ʊ l aː t oː r ɛ m
r ɛ s t ɛ m	r ɛ s t ɛ m
a b d uː k t j oː n ɛ m	a b d ʊ k t j oː n ɛ m
iː n k uː d ɪ fː ɛ	ɪ ŋ k uː d ɛ m
d ɛ m ɪ t ɪ r	d eː m ɪ tː ɛ r ɛ
iː n ʊ n d aː r ɛ	ɪ n ʊ n d aː r ɛ
iː n f ɛ l iː k ɛ	iː n f eː l iː k ɛ m
k a p ɛ lː a m	k a pː ɛ lː a m
m a k s ɪ lː aː r ɛ	m a k s ɪ lː a r ɛ m
r ɔ m iː k a m	r ʊ m ɪ k ɛ m
t ɛ m p ɔ r aː r j ʊ m	t ɛ m p ɔ r aː r j ʊ m
t r ɔ n ʊ m	tʰ r ɔ n ʊ m
s a l a k ɛ	s a l aː k ɛ m
w oː l a r ɛ	w ɔ l aː r ɛ
s iː t a s w ɛ m	k ɪ t aː t j oː n ɛ m
eː r g aː s t ʊ l ʊ m	ɛ r g a s t ʊ l ʊ m
s eː n ʊ m	s ɪ n ʊ m
s p ʊ r k aː r ɛ	s p ʊ r k aː r ɛ
s uː p iː n ʊ m	s ʊ p iː n ʊ m
lː a d r iː l ʊ m	l a t ɛ r k ʊ l ʊ m
d eː l iː t ʊ m	d eː l ɪ k t ʊ m
m a r g aː r iː t a m	m a r g a r iː t a m
r ɛ s t r ɪ ŋ g ɛ r ɛ m	r ɛ s t r ɪ ŋ g ɛ r ɛ
ɔ l ʊ m	ɔ l ʊ m
m a ŋ n ɛ s j ʊ m	m a ŋ n eː s j ʊ m
s ɪ n ʊ m	s ʊ iː n ʊ m
w eː r s iː k ʊ l ʊ m	w ɛ r s ɪ k ʊ l ʊ m
r ɛ s t aː r ɛ	r ɛ s t aː r ɛ
k ɔ m p l iː k a t j oː n ɛ	k ɔ m p l ɪ k aː t j oː n ɛ m
p ɔ k ʊ m m	p aʊ k ʊ m
p r ɔ d iː g aː r ɛ	p r oː d ɪ g ɛ r ɛ
ɔ r n aː t ʊ m	oː r n aː t ʊ m
p r ɛ m ɛ r ɛ	p r ɛ m ɛ r ɛ
