l aː d a t ɔ r ɛ m	l aʊ d aː t oː r ɛ m
l a r g ʊ m	l a r g ʊ m
g ɛ t aː r ɛ	j a k t aː r ɛ
m a g ɛ s t aː t ɛ m	m a j ɛ s t aː t ɛ m
k ɔ ɛ r ɛ	k ɔ r
a s ɪ m ɪ l aː r ɛ	a sː ɪ m ʊ l aː r ɛ
d a n t ʊ m	d a m n aː t ʊ m
g l aʊ k ʊ m	g l aʊ k ʊ m
aː k ʊ ŋ	ɛ kː ʊ m
k a m ɪ n ʊ m	k a mː iː n ʊ m
p lː ɛ n ɪ t uː d ɛ m	p l eː n ɪ t uː d ɪ n ɛ m
k ɪ n t uː r a m	k ɪ ŋ k t uː r a m
k ɔ n s ɛ r w a t j ʊ n ɛ m	k oː n s ɛ r w aː t j oː n ɛ m
ɛ lː ɛ g a n t ɛ m	eː l ɛ g a n t ɛ m
a d ɪ uː n t ʊ m	a d j ʊ ŋ k t ʊ m
k a l ɪ f ʊ m	k a l iː pʰ a m
f r ɛ kʷ g ɛ n t ɛ m	f r ɛ kʷ ɛ n t ɛ m
r ɔ t aː r ɛ	r ɔ t aː r ɛ
p ɛ r ɪ t a r t ɛ	p ɪ g r ɪ t aː r iː
p a r j ɪ ɛ t a l ɛ	p a r ɪ ɛ t aː l ɛ m
s a b l ʊ m	s a b ʊ l ʊ m
p r ɛ w a l eː r ɛ	p r aɪ w a l eː r ɛ
s k ɔ l ɔ p ɛ n d r a m	s k ɔ l ɔ p ɛ n d r a m
r ɔ rː ɪ k a	r oː r ɛ m
ɪ n f a n d ʊ m	iː n f a n d ʊ m
s ʊ b m ɛ r g ɛ r ɛ	s ʊ mː ɛ r g ɛ r ɛ
k ʊ l ɛ k ʊ m	k aʊ l ɪ k ʊ l ʊ m
g ɛ r ɛ r	g ɛ r ɛ r ɛ
d ɛ t ɛ s t a t j ʊ n ɛ m	d eː t ɛ s t aː t j oː n ɛ m
s ɛ r a m	s eː r ʊ m
d ɪ s t ɛ n d ɛ r ɛ	d ɪ s t ɛ n d ɛ r ɛ
k ʊ ɪ r ʊ m	k ɔ r j ʊ m
g l uː t ɪ n ɛ	g l uː t ɛ n
t ɔ r t ɪ l ɛ	t ɔ r t ɪ l ɛ m
k r ɔ k oː m	k r ɔ k ʊ m
w ɛ s t iː m ɛ n t ʊ m	w ɛ s t iː m ɛ n t ʊ m
s ɔ m ɪ ɛ r ʊ m	s a g m aː r j ʊ m
b r ɪ t a n ɪ k ʊ m	b r ɪ t a nː ɪ k ʊ m
d ɛ s ɪ n ɛ n s	d eː s ɪ n ɛ n t j a m
p r ɔ r ɔ g a t j ʊ n ɛ m	p r oː r ɔ g aː t j oː n ɛ m
k ʊ rː ɛ a m	k ɔ rː ɪ g j a m
g uː b ɪ l aː r ɛ	j uː b ɪ l aː r ɛ
k r ɛ m aː r ɛ	k r ɛ m aː r ɛ
a f lː ɛ n k j a m	a fː l ʊ ɛ n t j a m
w uː l n ɛ r aː r ɛ	w ʊ l n ɛ r aː r ɛ
a p a r ɪ r ɛ	a pː aː r eː r ɛ
s aː t ɪ r a m	s a t ɪ r a m
p a m p eː n ʊ m	p a m p ɪ n ʊ m
w ʊ l a r ɛ	w ɔ l aː r ɛ
ɔ lː aː r j ʊ m	ɔ lː aː r j ʊ m
a k r ɪ t uː d ɛ m	aː k r ɪ t uː d ɪ n ɛ m
p r ɔ b l ɛ m aː t ɪ k ʊ m	p r ɔ b l eː m a t ɪ k ʊ m
p a l ʊ	p aː l ʊ m
k a m p ɛ s t r ɛ m	k a m p ɛ s t r ɛ m
t ʊ s ɛ r ɛ	t ʊ sː iː r ɛ
k a p t uː r a m	k a p t uː r a m
k aː n ʊ m	k aː n ʊ m
t a k s a t j ʊ n ɛ m	t a k s aː t j oː n ɛ m
s uː p lː ɪ t j ʊ m	s ʊ pː l ɪ k j ʊ m
s ʊ r ɪ k ɪ r	s a r k iː r ɛ
a s k ɛ n d ɛ r ɛ	a s k ɛ n d ɛ r ɛ
a m ɪ k t ʊ m	a m ɪ k t ʊ m
a l a k r ɪ t aː t ɛ m	a l a k r ɪ t aː t ɛ m
r a s k aː r ɛ	r aː d ɛ r ɛ
w ɪ n k ʊ l aː r ɛ	w ɪ ŋ k ʊ l aː r ɛ
d ɪ g ɪ t a l ɛ	d ɪ g ɪ t aː l ɛ m
d eː r ɔ m p ɛ r ɛ	d iː r ʊ m p ɛ r ɛ
a d ɪ k t j ʊ n ɛ m	a dː ɪ k t j oː n ɛ m
l uː b r ɪ k ɪ t ɛ m	l uː b r ɪ k ɪ t aː t ɛ m
a d ɔ n k ʊ m	a d ʊ ŋ k ʊ m
f a k ʊ m d j a m	f aː k ʊ n d j a m
a n ɛ l j ʊ m	a nː ɪ k ʊ l ʊ m
t aɪ t ʊ m	t eː k t ʊ m
p l a g j aː r ɛ	p l a g j aː r ɛ
aː n j aː lː a m	a ŋ n ɛ lː a m
t ɔ r t ɛ r ɛ m	t ɔ r kʷ eː r ɛ
d eː s k ɪ ŋ g ɛ r ɛ	d ɪ s k ɪ ŋ g ɛ r ɛ
a k t w aː r ɛ	aː k t w aː r ɛ
ɪ t uː d ɪ n ɛ m	t uː d ɪ n ɛ m
ɛ s ɛ r k ɪ t ʊ m	ɛ k s ɛ r k ɪ t ʊ m
kʷ aː d r ʊ m	kʷ aː d r ʊ m
n f aː g r ɛ t ɛ r	n ɪ g r eː s k ɛ r ɛ
ɛ s p ɔ ŋ g a m	s p ɔ ŋ g j a m
a l t ɛ ʊ m	a l tʰ aɪ a m
k a n ɔ n ɛ	k a n ɔ n ɛ m
a s ɛ r ɪ r ɛ	a sː ɛ r ɛ r ɛ
iː m b ɛ k ɪ lː ɪ t aː t ɛ m	ɪ m b eː k ɪ lː ɪ t aː t ɛ m
k ɔ lː ɛ k t a m	k ɔ lː eː k t a m
kʷ ɔ l s r ɪ t	k ʊ l k ɪ t a m
k ɔ m p l a k ɛ r ɛ	k ɔ m p l a k eː r ɛ
ɛ k s p ɪ r aː r ɛ	ɛ k sː p iː r aː r ɛ
m ɛ r ɪ k aː r	m ɛ r k aː r iː
m ɔ n a s t ɛ r j ʊ m	m ɔ n a s t eː r j ʊ m
r ɛ k ɛ d ɛ r ɛ	r ɛ k eː d ɛ r ɛ
s uː b iː r ɛ	s ʊ b iː r ɛ
k aː t a m	k a tː a m
m ɪ ŋ g ɛ r ɛ	m ɪ ŋ g ɛ r ɛ
ɛ t ʊ m	eː t ʊ m
s ʊ b r ɪ ŋ ʊ m	s oː b r iː n ʊ m
f m ɪ m b r j aː t ʊ m	f ɪ m b r j aː t ʊ m
ɛ r ɔ ɛ m	h eː r oː ɛ m
k ɛ r w ɪ n ʊ m	k ɛ r w iː n ʊ m
k ɔ n t r a dː ɪ k t oː r ɛ	k ɔ n t r aː d ɪ k t oː r ɛ m
ɔ m l b ɪ d ɛ r ɛ	ɔ b l iː w ɪ s k iː
d eː w ɛ r ɛ	d eː b eː r ɛ
k r w ʊ r	k r ʊ oː r ɛ m
a s k ɛ n s j ʊ n ɛ m	a s k eː n s j oː n ɛ m
m a l f aː r ɛ	m a l ɛ f a k ɛ r ɛ
ɛ k s ɛ k r aː r ɛ	ɛ k sː ɛ k r aː r iː
l ɛ m a m	l ɛ mː a
k ɛ d r ʊ m	k ɛ d r ʊ m
a l t ɛ r k a t j ʊ n ɛ m	a l t ɛ r k aː t j oː n ɛ m
k a t ɛ lː ʊ m	k a t ɛ lː ʊ m
n ɔ m ɪ n a t j oː n ɛ	n oː m ɪ n aː t j oː n ɛ m
g uː r a t oː r ɛ	j uː r aː t oː r ɛ m
s ɔ l w ɛ r ɛ	s ɔ l w ɛ r ɛ
ɪ n w ɪ d j oː s ʊ m	ɪ n w ɪ d j oː s ʊ m
d s a b ʊ rː a m	s a b ʊ rː a m
w ɪ p ɪ r a m	w iː p ɛ r a m
a n a l ɪ s ɛ	a n a l y s ɛ m
f l ɛ k t ɛ r ɛ	f l ɛ k t ɛ r ɛ
iː n f l a m a t j ʊ n ɛ m	iː n f l a mː aː t j oː n ɛ m
a r k ɛ t ɪ p ʊ m	a r kʰ ɛ t y p ʊ m
a kː iː d j a m	a k eː d j a m
ɔ s p ɪ t j ʊ m	h ɔ s p ɪ t j ʊ m
a w ʊ k aː r ɛ	a d w ɔ k aː r ɛ
ɪ n uː m a n ɪ t aː t ɛ m	ɪ n h uː m aː n ɪ t aː t ɛ m
a r ɪ j oː lː ʊ m	h a r ɪ ɔ l ʊ m
l ɪ m ʊ m	l iː m ʊ m
d ɪ s t ɔ r t ɛ r ɛ m	d ɪ s t ɔ r kʷ eː r ɛ
k ʊ ʊ k ɪ n aː r ɛ	k ɔ kʷ iː n aː r ɛ
d ɛ s k r ɪ p t j ʊ n ɛ m	d eː s k r iː p t j oː n ɛ m
m ʊ l aː r ɛ	m ɔ l aː r ɛ m
d ɛ s k r ɪ w ɛ r ɛ	d eː s k r iː b ɛ r ɛ
s k ʊ m	ɪ s k ʊ m
s aː m b ʊ k ʊ m	s a m b uː k ʊ m
r ɛ p ɛ lː ɛ r ɛ	r ɛ p ɛ lː ɛ r ɛ
s ʊ lː aː k ʊ	s oː l aː k j ʊ m
p a s t ɪ m n aː k a m	p a s t ɪ n aː k a m
s ɛ n s a t j ʊ n ɛ m	s eː n s aː t j oː n ɛ m
p uː l w ɪ n a r ɛ	p ʊ l w iː n a r
a l uː m n ʊ m	a l ʊ m n ʊ m
g ɛ t ʊ m	j a k t ʊ m
iː n f l ɪ k t j oː n ɛ m	ɪ n f l ɪ k t j oː n ɛ m
l j ɛ t aː r ɛ	f eː t aː r ɛ
lː uː m b r k aː r ɛ	l uː k ʊ b r aː r ɛ
a b r ɔ t a n ʊ m	a b r ɔ t ɔ n ʊ m
k uː w ɪ l	k ʊ b iː l ɛ
k a p ɪ t l ʊ m	k a p ɪ t ʊ l ʊ m
w ɛ r s ɪ f ɪ k aː r ɛ	w ɛ r s ɪ f ɪ k aː r ɛ
a d m ɪ n ɪ s t r aː r ɛ	a d m ɪ n ɪ s t r aː r ɛ
g r aː t ʊ m	g r aː t ʊ m
b a kː a l eː r aː t ʊ m	b a kː a l aʊ r ɛ a t ʊ m
k ɔ l ʊ m b ɪ n ʊ m	k ɔ l ʊ m b iː n ʊ m
a t lː a n t ɪ k ʊ m	aː t l a n t ɪ k ʊ m
k ɛ l aː r ɛ	k eː l aː r ɛ
m ɔ r ɪ b ʊ n d ʊ m	m ɔ r ɪ b ʊ n d ʊ m
l a ŋ gʷ ɪ d ʊ m	l a ŋ gʷ ɪ d ʊ m
k ɔ s ʊ m	k ɔ k s ʊ m
k a n t oː r ɛ	k a n t oː r ɛ m
a r g ɪ n t oː s ʊ m	a r g ɛ n t oː s ʊ m
k ɔ n s t ɪ t uː t ɪ w ʊ m	k ɔ n s t ɪ t uː t ɪ w ʊ m
ɪ n ʊ s ɛ r ɛ	ɪ ŋ n oː s k ɛ r ɛ
t ɪ m ʊ n ɛ m	t eː m oː n ɛ m
g uː d ɪ k a t oː r ɛ	j uː d ɪ k aː t oː r ɛ m
iː m b ɛ k ɪ lː ɛ	ɪ m b eː k ɪ lː ʊ m
b r aː k a m	b r aː k a m
d ɔ m ɛ s t ɪ k ʊ m	d ɔ m ɛ s t ɪ k ʊ m
ɛ f ɛ k t aː ɛ r ɛ	ɛ fː ɪ k ɛ r ɛ
a r b ʊ t ʊ m	a r b ʊ t ʊ m
ɔ b j ʊ m g	ɔ b w j ʊ m
t r aː lː a m	t r aː g ʊ l a m
s k ʊ rː ɛ r ɛ	ɛ k s k ʊ rː ɛ r ɛ
lː ɛ n a d ɔ r	l ɪ ŋ n aː t oː r ɛ m
k ɔ m p a s ɪ b lː ɛ	k ɔ m p a sː ɪ b ɪ l ɛ m
m a t r ɪ k ɪ d j ʊ m	m aː t r ɪ k iː d j ʊ m
a g r ɪ m ɛ n s oː r ɛ	a g r iː m eː n s oː r ɛ m
iː n s ɪ n w aː r ɛ	iː n s ɪ n w aː r ɛ
ɔ r t ɛ n a t oː r	ɔ r d ɪ n aː t oː r ɛ m
w ɪ s aː r ɛ	w iː s ɛ r ɛ
t uː m ɪ d ʊ m	t ʊ m ɪ d ʊ m
l ɪ m ɪ t aː r ɛ	l iː m ɪ t aː r ɛ
g ɔ s ʊ m	g ɛu s j aː s
p r ɛ d a t oː r ɛ	p r aɪ d aː t oː r ɛ m
r ɛ t j aː r j ʊ m	r eː t j aː r j ʊ m
f r uː ɪ k t ʊ m	f r uː k t ʊ m
p ʊ t aː r ɛ m m	p ʊ t aː r ɛ
p r ɛ a m b ʊ l ʊ m	p r aɪ a m b ʊ l ʊ m
k ɔ rː ɔ s j oː n ɛ m	k ɔ rː oː s j oː n ɛ m
w a r j ɪ ɛ t aː t ɛ m	w a r ɪ ɛ t aː t ɛ m
k a m a r a m	k a m a r a m
b oː w aː r ʊ m	b ɔ w aː r j ʊ m
p iː n t ʊ m	p ɪ k t ʊ m
ɔ n uː ɛ	ɔ n ʊ s
k ɔ n t ɪ n w ʊ m	k ɔ n t ɪ n ʊː m
g ɛ b ʊ m	g ɪ bː ʊ m
p uː p ɪ lː a m	p uː p ɪ lː a m
k a n iː n ʊ m	k a n iː n ʊ m
l ɪ m oː s ʊ m	l iː m oː s ʊ m
f r a t ɛ r n ɪ t aː t ɛ m	f r aː t ɛ r n ɪ t aː t ɛ m
s a l s a m	s a l s a m
k a d aː w ɛ r ɛ	k a d aː w ɛ r
ɛ k s a m ɪ n aː r ɛ	ɛ k s aː m ɪ n aː r ɛ
s ɪ t a s w ɛ m	k ɪ t aː t j oː n ɛ m
aː k ɪ n ʊ m	a k ɪ n ʊ m
a f ʊ g aː r	ɔ fː oː k aː r ɛ
d ɪ n k a s ɛ	d eː n s aː r ɛ
f l ɔ w aː	f l ʊ w j ʊ m
ɛ g r eː g ʊ m	eː g r ɛ g j ʊ m
g ɛ n t ɪ l ɪ t a m	g ɛ n t iː l ɪ t aː t ɛ m
iː n d ɪ ŋ n ɪ t aː t ɛ m	ɪ n d ɪ ŋ n ɪ t aː t ɛ m
a t ɛ n t ʊ m m	a tː ɛ n t ʊ m
f ʊ ŋ g oː s ʊ m	f ʊ ŋ g oː s ʊ m
ɛ m ɛ k r ɪ n ɪ	s k r iː p t ʊ m
n ɛ f aː r j ʊ m	n ɛ f aː r j ʊ m
d ɛ s t ɪ n aː r ɛ	d eː s t ɪ n aː r ɛ
f a b ɛ lː a m	f aː b ɛ lː a m
a r k aː r ʊ m	a r k w aː r j ʊ m
k ɔ m m ɛ m ɔ r a t j ʊ n ɛ m	k ɔ mː ɛ m ɔ r aː t j oː n ɛ m
k ɪ p a m	k eː p a m
lː ɔ m k a m	l uː t ɛu m
ɛ f ɪ k a t ɪ t aː	ɛ fː ɪ k aː k ɪ t aː t ɛ m
f aɪ d	f ɪ d ɛ m
p a k aː r ɛ	p aː k aː r ɛ
p l a n ɛ t a m	p l a n eː t a m
p r ɛ n ʊ m	p r aɪ ŋ n aː t ɛ m
f l ɛ m a m	pʰ l ɛ g m a
ɪ m b ʊ ɪ r	ɪ m b ʊ ɛ r ɛ
d ɛ n uː d a t j ʊ n ɛ m	d eː n uː d aː t j oː n ɛ m
a m b ɔ s	a m b oː s
k ɔ lː ɛ k t j oː n ɛ m	k ɔ lː eː k t j oː n ɛ m
ʊ r t ɪ k aː r j a m	ʊ r t iː k aː r j a m
b ʊ k j ɪ n ɛ	b uː k ɪ n ʊ m
t ɔ m ʊ	t ɔ m ʊ m
p a g a n ɪ t aː t a m	p aː g aː n ɪ t aː t ɛ m
n ɛ r w j ʊ m	n ɛ r w ʊ m
aː d ɪ p ɛ m	a d ɪ p ɛ m
p aː t r j a m	p a t r j a m
r m ɛ aː l ɪ t aː t ɛ m	r ɛ aː l ɪ t aː t ɛ m
a b ɔ m aː s ʊ m	a b ɔ m aː s ʊ m
s uː p ɛ r j oː r ɛ	s ʊ p ɛ r j oː r ɛ m
l a m ɛ n t ʊ m	l aː m ɛ n t ʊ m
t ʊ r p ɛ d ʊ m	t ɔ r p eː d ɪ n ɛ m
p ʊ l w ɛ r ɪ zː aː r ɛ	p ʊ l w ɛ r iː zː aː r ɛ
d ɛ k l ɪ n aː r ɛ	d eː k l iː n aː r ɛ
kʷ a d r a g ɛ s ɪ m ʊ m	kʷ aː d r aː g eː s ɪ m ʊ m
ɪ n s ɛ m n aː r ɛ	iː n s ɪ ŋ n aː r ɛ
w ɔ ɪ s	w oː s
k a n ɪ k ʊ l a m	k a n iː k ʊ l a m
b r aː k ɛ m	b r aː k aː s
g a n ɪ r	g a nː iː r ɛ
a ɛ r ɛ ʊ m	aː ɛ r j ʊ m
s aː s ʊ m	s a k s ʊ m
f uː n ɪ k ʊ l ʊ m	f uː n ɪ k ʊ l ʊ m
s ʊ g h ɛ k t ʊ m	s ʊ b ɪ ɛ k t ʊ m
ɛ m ɔ l uː m ɛ n t ʊ m	eː m ɔ l ʊ m ɛ n t ʊ m
t ʊ rː m ɛ m	t ʊ rː ɛ m
m ʊ l t ɪ p l ɪ k a t j oː n ɛ	m ʊ l t ɪ p l ɪ k aː t j oː n ɛ m
a l t aː r ɛ	a l t a r ɛ m
p iː n t uː r a m	p ɪ k t uː r a m
ɪ m p ɛ lː ɛ r ɛ	ɪ m p ɛ lː ɛ r ɛ
a k k ɛ n t ʊ m	a kː ɛ n t ʊ m
s aʊ l t ʊ m	s a l t ʊ m
ɔ w ɛ l j a m	ɔ w ɪ k ʊ l a m
ɪ b r ɪ d ʊ m	h y b r ɪ d a m
w ɛ s k ɛ m m	w eː s k ʊ m
d ɛ p l ɔ r aː r ɛ	d eː p l oː r aː r ɛ
d aː m b uː l a t j ʊ n ɛ m	d ɛ a m b ʊ l aː t j oː n ɛ m
a n ɪ m ʊ m	a n ɪ m ʊ m
k a p ɪ t ʊ l a t j ʊ n ɛ m	k a p ɪ t ʊ l aː t j oː n ɛ m
k aʊ d a l ɛ	k aʊ d aː l ɛ m
a r k a n ʊ m	a r k aː n ʊ m
f l oː r eː r ɛ	f l oː r eː r ɛ
ɔ r a t j ʊ n ɛ m	oː r aː t j oː n ɛ m
r ɛ uː m	r h ɛu m a
k ʊ m p ɛ lː ɛ r	k ɔ m p ɛ lː ɛ r ɛ
d ɪ k aː k ɛ	d ɪ k aː k ɛ m
k ʊ p r ɪ ɛ ʊ	k uː p r ʊ m
k r uː ɛ l ɛ	k r uː d eː l ɛ m
ɪ n ɛ b r j aː r ɛ	ɪ n eː b r j aː r ɛ
a g ɪ t a d ɔ r	a g ɪ t aː t oː r ɛ m
a kʷ ɪ l ɪ n ʊ m	a kʷ ɪ l iː n ʊ m
t aʊ r ɪ f ɔ r m ɛ	t aʊ r ɪ f oː r m ɛ m
r aː n k oː r ɛ	r a ŋ k oː r ɛ m
a n a r k j a m	a n a r kʰ j a m
ɪ n k a n t aː r ɛ	ɪ ŋ k a n t aː r ɛ
l a ŋ g oː r ɛ m	l a ŋ gʷ oː r ɛ m
f ɪ g uː r a m	f ɪ g uː r a m
l ɔ m b ʊ m	l ʊ m b ʊ m
b a r b ʊ l ʊ m	b a r b ʊ l a m
f ʊ l ɪ g ɪ n ɛ m	f uː l iː g ɪ n ɛ m
a m p l ɪ t uː d	a m p l ɪ t uː d ɪ n ɛ m
a t s k r ɪ w ɪ r ɛ	aː s k r iː b ɛ r ɛ
n aː f t a m	n a pʰ tʰ a m
k ɪ n ʊ m	k y ŋ n ʊ m
d ɪ g ɪ t aː r ɛ	d ɪ g ɪ t aː r ɛ
r ɔ t ɛ lː a m	r ɔ t ɛ lː a m
iː n s t aʊ r aː r ɛ	iː n s t aʊ r aː r ɛ
n ɛ g ɔ t j a t j ʊ n ɛ m	n ɛ g oː t j aː t j oː n ɛ m
t r a n s ɪ r ɛ	t r aː n s iː r ɛ
l ɪ b ɪ d ʊ m	l ɪ b iː d ɪ n ɛ m
l ɛ t ʊ m	l eː k t ʊ m
ɛ m s t iː ŋ gʷ ɛ r ɛ m	ɛ k s t ɪ ŋ gʷ ɛ r ɛ
ɪ m p ɛ r j ʊ m	ɪ m p ɛ r j ʊ m
a lː uː d ɪ r ɛ	a lː uː d ɛ r ɛ
ɔ r ɪ g ɪ n aː r j ʊ m	ɔ r iː g ɪ n aː r j ʊ m
n aʊ s a m	n aʊ s j a m
p j oː ʊ m m	p j ʊ m
ɔ t r ɛ m	ʊ t r ʊ m
m uː n ɪ t j ʊ m m	m uː n iː t j oː n ɛ m
f a j a l ɛ	f a k j aː l ɛ m
ɛ d ɪ k ʊ l a m	aɪ d ɪ k ʊ l a m
f ɛ m ɪ n a m	f eː m ɪ n a m
f a h m a m	f aː m a m
f ɛ rː aː t ʊ m	f ɛ rː aː t ʊ m
a k uː m uː l a t j ʊ n ɛ m	a kː ʊ m ʊ l aː t j oː n ɛ m
m ɪ r t ɪ lː ʊ m	m y r t ɪ lː ʊ m
k a r ɪ k k ɛ m	k aː r ɪ k ɛ m
w h ɛ r m ɛ m	w ɛ r m ɛ m
n uː t r ɪ k aː r ɛ	n uː t r iː k aː r ɛ
uː l t ʊ r ɛ	ʊ l t oː r ɛ m
f ɛ s t ʊ m	f eː s t ʊ m
a n t aː r ɛ	a m b ʊ l aː r ɛ
t ɛ n j ɛ b r ɛ m	t ɛ n ɛ b r aː s
t r a m s ɪ g ɛ r ɛ	t r aː n s ɪ g ɛ r ɛ
k ɪ r k uː lː aː r	k ɪ r k ʊ l aː r ɛ
k a d uː k ʊ m	k a d uː k ʊ m
p ɛ t ʊ m	p eː d ɪ t ʊ m
a s t ʊ r ɛ	a s t ʊ r ɛ m
k r ɪ m ɪ n ɛ	k r iː m ɛ n
h ɛ lː ʊ m	ɛ lː ʊ m
d ʊ m aː r ɛ	d ɔ m aː r ɛ
d s ɛ f ɪ r ʊ m	z ɛ pʰ y r ʊ m
ɛ k s k l uː ɛ r ɛ	ɛ k s k l uː d ɛ r ɛ
s ɛ n aː t ʊ m	s ɛ n aː t ʊ m
w ɪ t uː l ʊ m	w ɪ t ʊ l ʊ m
ɪ lː uː d ɪ r	ɪ lː uː d ɛ r ɛ
f ʊ l a k a m	f ʊ l ɪ k a m
k ɔ n t ɛ n t j oː n ɛ m	k ɔ n t ɛ n t j oː n ɛ m
rː ɛ lː a k s a t j oː n	r ɛ l a k s aː t j oː n ɛ m
m a n t ɪ p m j ʊ m	m a ŋ k ɪ p j ʊ m
p a g ɛ lː a m	p aː g ɛ lː a m
w ɪ s ɪ b ɪ lː ɪ d aː d ɛ m	w iː s ɪ b ɪ l ɪ t aː t ɛ m
ɔ p ɔ m r ɛ	ɔ pː oː n ɛ r ɛ
k uː lː a m	k uː n a m
uː s ɪ t aː r ɛ	uː s ɪ t aː r iː
ɛ d ɪ l	aɪ d iː l ɛ m
uː d ʊ m	uː d ʊ m
iː n t ɛ rː uː p t j ʊ n ɛ m	ɪ n t ɛ rː ʊ p t j oː n ɛ m
b a p t ɪ s t a m	b a p t ɪ s t a m
k r ɪ t ɪ k ʊ m	k r ɪ t ɪ k ʊ m
t r a m a m	t r aː m a m
p a r t ʊ r j ɛ m	p a r t ʊ r iː r ɛ
k a n ɔ r ʊ m	k a n oː r ʊ m
b a r b aː t ʊ m	b a r b aː t ʊ m
t r ɪ k ɛ	t r iː k ɛ m
f ɪ d aː r ɛ	f iː d ɛ r ɛ
p r ɛ s a g j aː r ɛ	p r aɪ s aː g iː r ɛ
w oː m ɪ t ʊ m	w ɔ m ɪ t ʊ m
ɔ k l uː ɛ r ɛ	ɔ kː l uː d ɛ r ɛ
a l aː	aː l ɛ a m
d ɛ s ɔ l aː r ɛ	d eː s oː l aː r ɛ
k ɔ n s k ɛ j ɛ n t j a m	k oː n s k ɪ ɛ n t j a m
f uː l w ʊ m	f ʊ l w ʊ m
d ɛ n t a l ɛ	d ɛ n t aː l ɛ m
p ɛ k uː n j aː r j ʊ m	p ɛ k uː n j aː r j ʊ m
s ɛ d ɛ m	s eː d ɛ m
ɔ lː ɔ r	ɔ l oː r ɛ m
iː n w ɛ r t iː r ɛ	ɪ n w ɛ r t ɛ r ɛ
ʊ k s w ɛ m	uː ŋ k t j oː n ɛ m
d ɛ d uː k t j oː n ɛ m	d eː d ʊ k t j oː n ɛ m
ɛ f ɛ m ɪ n r ɛ	ɛ fː eː m ɪ n aː r ɛ
ɛ g s ɛ r k ɛ r ɛ	ɛ k s ɛ r k eː r ɛ
k ɪ r k ʊ n l ʊ k uː t j ʊ n ɛ	k ɪ r k ʊ m l ɔ k uː t j oː n ɛ m
a d ɔ r m iː r ɛ	a dː ɔ r m iː r ɛ
a s ʊ lː aː r	a sː ɔ l aː r ɛ
d ɛ l iː n kʷ ɛ r ɛ	d eː l ɪ ŋ kʷ ɛ r ɛ
p ɔ p l ɪ t ɛ m	p ɔ p l ɪ t ɛ m
m ɪ t ɪ g a t j ʊ n ɛ m	m iː t ɪ g aː t j oː n ɛ m
k ɔ n w ɔ k a t j ʊ n ɛ m	k ɔ n w ɔ k aː t j oː n ɛ m
rː ɛ w ɛ r b ɛ r aː r ɛ	r ɛ w ɛ r b ɛ r aː r ɛ
k ɔ n t r ɪ b ʊ ɛ r ɛ	k ɔ n t r ɪ b ʊ ɛ r ɛ
a m a l g a m a m	a m a l g a m a
ɛ rː oː k ʊ ʊ m	w ɛ r ɪ k ʊ l ʊ m
k a s t aː n a m	k a s t a n ɛ a m
a b uː s aː r ɛ	a b uː t iː
ɛ d ɪ f ɪ k a k j oː n	aɪ d ɪ f ɪ k aː t j oː n ɛ m
ɪ s t ʊ m	ɪ s t ʊ m
uː r ʊ m	uː r ʊ m
ɛ k s a l t aː r ɛ	ɛ k s a l t aː r ɛ
t ɛ m s uː r a m	k eː n s uː r a m
p ɔ s ɛ s oː r ɛ	p ɔ sː ɛ sː oː r ɛ m
p ɛ s k aː r j ʊ m	p ɪ s k aː r j ʊ m
ɪ n k ʊ r w aː r ɛ	ɪ ŋ k ʊ r w aː r ɛ
s ɛ p ʊ l m aː r ɛ	s ɛ p ɛ l iː r ɛ
d ɛ r ɪ s w oː r ʊ	d eː r iː s oː r j ʊ m
ɪ m s k ʊ g aː r ɛ	ɛ k sː uː k aː r ɛ
m a t ɛ r n ʊ m m	m aː t ɛ r n ʊ m
iː n f ɪ m ʊ m	iː n f ɪ m ʊ m
p r ɔ s t ɪ t ʊ ɛ r ɛ	p r oː s t ɪ t ʊ ɛ r ɛ
a b j ɛ k t aː r ɛ	a b ɪ k ɛ r ɛ
s aː t ɪ s f a k t j oː n ɛ m	s a t ɪ s f a k t j oː n ɛ m
aʊ r a m	aʊ r a m
ɛ k s p ɛ k t a t j ʊ n ɛ	ɛ k sː p ɛ k t aː t j oː n ɛ m
s p a r g ɛ r ɛ	s p a r g ɛ r ɛ
n uː t aː r	n uː t aː r ɛ
l ʊ k r ʊ m	l ʊ k r ʊ m
t r a d ɪ t oː r ɛ	t r aː d ɪ t oː r ɛ m
k aː t aː r ɛ	k ɔ a k t aː r ɛ
s k a l p ɛ lː ʊ m	s k a l p ɛ lː ʊ m
p ɛ r a m	p eː r a m
a ŋ g ɔ s t aː r ɛ	a ŋ g ʊ s t aː r ɛ
d j ɪ k ɪ m ʊ m	d ɛ k ɪ m ʊ m
a r m aː m ɪ eː n t ʊ m	a r m aː m ɛ n t ʊ m
k uː rː ɪ k ʊ l ʊ m	k ʊ rː ɪ k ʊ l ʊ m
