k ɔ m ɛ t ɛ r ɛ	k ɔ mː ɪ tː ɛ r ɛ
ɪ rː ɪ t aː	ɪ rː iː t aː r ɛ
ɛ m ɪ k r aː n j a m	h eː m ɪ k r aː n j a m
d ɔ r aː r ɛ	d ɛ aʊ r aː r ɛ
b ɔ s k ɪ m	b ɔ s k ʊ m
s ʊ k b l w aː r ɛ	s iː b ɪ l aː r ɛ
r ɛ k ɛ s ɪ w ʊ m	r ɛ k ɛ sː iː w ʊ m
k ɔ m a n d aː r ɛ	k ɔ mː ɛ n d aː r ɛ
k l a m oː r ɛ m	k l aː m oː r ɛ m
a b h ɪ l ɛ m	aː b ɪ l ɛ m
p a p w eː r j ʊ m	p a p y r ʊ m
k aː k t ɪ w ʊ m	k a p t iː w ʊ m
h ɔ s p eː t ɛ m	h ɔ s p ɪ t ɛ m
k ɔ n w ɛ r t eː r ɛ m	k ɔ n w ɛ r t ɛ r ɛ
m ɔ d ɛ r aː t oː r ɛ	m ɔ d ɛ r aː t oː r ɛ m
l a bː r ʊ m	l a b r ʊ m
d ɪ s t ɛ n d ɛ r ɛ	d ɪ s t ɛ n d ɛ r ɛ
p l ʊ m b aː t ɪ k ɛ n ɛ ʊ m	p l ʊ m b aː g ɪ n ɛ m
m ɛ r ɛ t r iː k ɛ	m ɛ r ɛ t r iː k ɛ m
eː kʷ ɪ p aː t aː r aː r ɛ	aɪ kʷ ɪ p ɛ r aː r ɛ
aɪ kʷ ʊ m	aɪ kʷ ʊ m
p ɛ l ɛ m b l aː r ɛ	p ɛ r a m b ʊ l aː r ɛ
f ɛ h ɔ ʊ n d a m	f ʊ n d a m
w a k aː r ɛ	w a k aː r ɛ
s t r ɔ pː ʊ m	s t r ɔ pː ʊ m
d uː b ɪ t aː t j oː n ɛ m	d ʊ b ɪ t aː t j oː n ɛ m
p ɛ r m ɪ s j oː n ɛ m	p ɛ r m ɪ sː j oː n ɛ m
ɛ k r b ɛ m d j ʊ m	a r b ʊ t ʊ m
r a p ʊ m	r aː p ʊ m
m a n ɪ f ɛ s t aː r ɛ m	m a n ɪ f ɛ s t aː r ɛ
h aː b ʊ l aː r ɛ	f aː b ʊ l aː r iː
s kʰ ɪ n t iː pʰ ɪ k ʊ m	s k ɪ ɛ n t ɪ f ɪ k ʊ m
ɪ n f ɛ l ɪ k ɛ	iː n f eː l iː k ɛ m
s p ɪ n ʊ lː a m	s p iː n ʊ l a m
g a m b a m	g a m b a m
l uː b r ɪ k iː t ɛ m	l uː b r ɪ k ɪ t aː t ɛ m
f ʊ l g oː r ɛ m	f ʊ l g oː r ɛ m
ɔ s k uː l aː t j oː n ɛ m	ɔ s k ʊ l aː t j oː n ɛ m
s ʊ gː k ʊ m	s ʊ l k ʊ m
ɪ m p ɛ r aː t ʊ r j ʊ m	ɪ m p ɛ r aː t oː r j ʊ m
r a p ɪ d ʊ m	r a p ɪ d ʊ m
k r a p ʊ l m a m	k r aː p ʊ l a m
p uː p ɪ lː ʊ m	p uː p ɪ lː ʊ m
d ɪ s kʷ ɪ s iː t j oː n ɛ m	d ɪ s kʷ iː s iː t j oː n ɛ m
t r aː n s f ɔ r m a t j oː n ɛ m	t r aː n s f oː r m aː t j oː n ɛ m
ɪ m a g ɛ n ɛ m	ɪ m aː g ɪ n ɛ m
a lː ɪ	ɪ lː ʊ ŋ k
eː l aɪ f a n t ɪ n ʊ m	ɛ l ɛ pʰ a n t ɪ n ʊ m
k ɔ n s ɛ ŋ n aː r ɛ	k oː n s ɪ ŋ n aː r ɛ
f ɪ l j aː l ɛ m	f iː l j aː l ɛ m
a sː ɔ l aː	a sː ɔ l aː r ɛ
g ɪ d aː r ʊ l a m	z iː z y pʰ ʊ m
m a ŋ n ɪ t uː d ɛ m	m a ŋ n ɪ t uː d ɪ n ɛ m
g ɛ ɔ m ɛ t r j a m	g ɛ oː m ɛ t r j a m
ɪ n k a r n aː r ɛ	ɪ ŋ k a r n aː r ɛ
ɪ d ɛ n t ɪ k ʊ m	iː d ɛ n t ɪ k ʊ m
a g r aː r j ʊ m	aː g r aː r j ʊ m
r ɛ k t ɪ t uː d ɪ n ɛ m	r ɛ k t ɪ t uː d ɪ n ɛ m
s t r ɪ d eː r ɛ	s t r iː d ɛ r ɛ
ɔ n a g r ʊ m	ɔ n a g r ʊ m
b ɛ t ʊ lː a m	b ɛ t ʊ l a m
p ɪ p aː r ɛ	p iː p aː r ɛ
k ɔ aʊ t ʊ m	k ɔ ɪ t ʊ m
l ɛ t ɪ t j j aː m	l aɪ t ɪ t j a m
r ɛ s k iː n d ɛ r ɛ	r ɛ s k ɪ n d ɛ r ɛ
m ɛ r g ɛ r ɛ m	m ɛ r g ɛ r ɛ
t ɔ r p oː r ɛ	t ɔ r p oː r ɛ m
ɔ b aɪ d ɛ t ɛ r ɛ	ɔ b ɔ ɪ d iː r ɛ
k ʊ l oː n ʊ m	k ɔ l oː n ʊ m
a r l ʊ m	h a r ɪ ɔ l ʊ m
s ʊ s t ɛ k n t aː k ʊ l ʊ m	s ʊ s t ɛ n t aː k ʊ l ʊ m
d ɔ k t oː r ɛ m	d ɔ k t oː r ɛ m
f ɔ r n ɪ k s ɛ m	f ɔ r n ɪ k ɛ m
s ʊ m ɪ t k ɪ t ɪ n ɛ m	s ʊ mː ɪ t aː t ɛ m
a r m t ɛ n t ʊ m	a r m aː m ɛ n t ʊ m
d ɛ r ɪ s j oː n ɛ m	d eː r iː s j oː n ɛ m
t r a w ɛ m	t r a b ɛ m
f ɪ d ɛ l ɛ	f ɪ d eː l ɛ m
p ɛ r d ɛ r ɛ	p ɛ r d ɛ r ɛ
a rː a s	a rː h a m
s ʊ p ɛ r s ɛ d eː r ɛ m	s ʊ p ɛ r s ɛ d eː r ɛ
s uː p l ɛ m ɛ n t ʊ m	s ʊ pː l eː m ɛ n t ʊ m
s ʊ ɛ a m	s ʊ ɛ m
ɔ l ɪ g aː r k a m	ɔ l ɪ g a r kʰ a m
a k ɔ n ɪ t ʊ m	a k ɔ n iː t ʊ m
d eː l uː b r ʊ m	d eː l uː b r ʊ m
a b ɪ s m ʊ m	a b y sː ʊ m
ɛ k s a s p ɛ r aː t j oː n ɛ m	ɛ k s a s p ɛ r aː t j oː n ɛ m
g uː r ʊ m	ɪ uː s
m a r ɪ t ʊ m	m a r iː t ʊ m
w eː r n aː l ɛ	w ɛ r n aː l ɛ m
a b uː s ʊ w ʊ m	a b uː s iː w ʊ m
a d uː l aː k j oː n ɛ m	a d uː l aː t j oː n ɛ m
r ɛ n ʊ n k j aː r ɛ	r ɛ n ʊ n t j aː r ɛ
k ɔ n t r oː w eː r s j a m	k ɔ n t r oː w ɛ r s j a m
g l aː d j ʊ m m	g l a d j ʊ m
r ɪ t ʊ m	r iː t ʊ m
f ɛ r a m	f ɛ r a m
ɪ n s t aʊ r aː r ɛ	iː n s t aʊ r aː r ɛ
f r ɪ k t j oː n ɛ	f r ɪ k t j oː n ɛ m
a b d oː m ɛ n	a b d oː m ɛ n
p ɔ s t r iː b ʊ l ʊ m	p r oː s t ɪ b ʊ l ʊ m
ɪ ŋ g ɛ n j s ʊ m	ɪ ŋ g ɛ n j oː s ʊ m
k r ʊ s t oː s ʊ m	k r ʊ s t oː s ʊ m
k ɛ l ɛ b r ɛ m	k ɛ l ɛ b r ɛ m
l ɪ b ɛ r aː t oː r ɛ	l iː b ɛ r aː t oː r ɛ m
g uː d aɪ m ʊ m	j uː d aɪ ʊ m
s uː b s ɪ d j ʊ m	s ʊ b s ɪ d j ʊ m
f ɔ r ɛ m aː r ɛ	f ɔ r aː r ɛ
f ɪ g uː r a m	f ɪ g uː r a m
ɛ rː eː ɪ r ɛ m	ɛ rː oː r ɛ m
b a r b aː r ɪ m ʊ m	b a r b a r ɪ s m ʊ m
r uː gː s ɪ n oː m ɛ m	l ʊ s k ɪ n j a m
t ɛ r t j ʊ m	t ɛ r t j ʊ m
s ɛ p t ɛ n t r j oː n ɛ m	s ɛ p t ɛ n t r j oː n ɛ m
a l w aː r ʊ m	a l b aː r j ʊ m
ɛ k s p l ɪ k aː t j oː n ɛ m	ɛ k s p l ɪ k aː t j oː n ɛ m
d eː p ɛ n d ɛ r ɛ	d eː p ɛ n d eː r ɛ
p r ɛ s k r iː b ɛ r ɛ m	p r aɪ s k r iː b ɛ r ɛ
eː k s k ɛ t aː r aː r ɛ m	ɛ k s k ɪ p ɛ r ɛ
p uː p ɪ lː a m	p uː p ɪ lː a m
a n ɛ k s ʊ m	a nː ɛ k s ʊ m
s ʊ s t ɛ n t aː r ɛ	s ʊ s t ɛ n t aː r ɛ
m ɪ r t ɪ lː ʊ m	m y r t ɪ lː ʊ m
k ɔ n k ʊ rː ɛ r ɛ	k ɔ ŋ k ʊ rː ɛ r ɛ
s ɔ k ɛ r a m	s ɔ k r ʊ m
k ɔ n k ɪ s ʊ m	k ɔ ŋ k ɪ d ɛ r ɛ
uː n ɪ k ʊ m	uː n ɪ k ʊ m
k aɪ n ʊ m	k aɪ n ʊ m
ɪ m p l oː r aː r ɛ	ɪ m p l oː r aː r ɛ
f ɪ n iː	f iː n ɛ m
l ɪ b ɛ r aː l ɪ t aː t ɛ m	l iː b ɛ r aː l ɪ t aː t ɛ m
f ɪ d ʊ m	f iː d ʊ m
g ɔ k ʊ n d iː t aː t ɛ m	j uː k ʊ n d ɪ t aː t ɛ m
k ɔ m f ɛ s aː r ɛ	k oː n f ɪ t eː r iː
f a ɛ n a m	f aː g ɪ n ʊ m
p r uː d iː r ɛ m	p r uː r iː r ɛ
k r ɛ m a m	k r aː m ʊ m
ɪ m p ɛ r j oː s ʊ m	ɪ m p ɛ r j oː s ʊ m
ɔ b s ɛ k j s ʊ m	ɔ b s ɛ kʷ j oː s ʊ m
t ɛ r ɛ b r a m	t ɛ r ɛ b r a m
ɛ k k ɛ lː eː r ɛ	ɛ k s k ɛ lː ɛ r ɛ
t r uː k ɛ m	t r ʊ k ɛ m
ɪ n f r ɪ ŋ g ɛ r ɛ	iː n f r ɪ ŋ g ɛ r ɛ
m ɔ r t aː r j ʊ m	m ɔ r t w aː r j ʊ m
k ɔ n m ʊ t aː r ɛ	k ɔ mː uː t aː r ɛ
a ŋ n aː t ʊ m	a ŋ n aː t ʊ m
l a b ʊ r aː r ɛ	l a b oː r aː r ɛ
p uː n ɪ r ɛ	p uː n iː r ɛ
a n ɪ h ɪ l aː t j oː n ɛ m	a nː ɪ h ɪ l aː t j oː n ɛ m
r ɛ k ɛ n s iː r ɛ	r ɛ k eː n s eː r ɛ
m a kʰ ɪ n aː r ɛ	m aː kʰ ɪ n aː r iː
g r aː n ʊ m	g r aː n ʊ m
t ɪ n t a r ɛ m	t ɪ ŋ g ɛ r ɛ
ɪ ŋ g r aː t ʊ m	ɪ ŋ g r aː t ʊ m
k ʊ m p l ɛ r ɛ	k ɔ m p l eː r ɛ
j uː d aː r ɪ k aː t oː r ɛ	j uː d ɪ k aː t oː r ɛ m
ɪ ŋ g ɛ r iː r ɛ	ɪ ŋ g ɛ r ɛ r ɛ
g ɪ l oː s ʊ m	z eː l oː s ʊ m
uː ŋ kː ʊ k oː t oː y ɛ m	m aː l ʊ m k ɔ t oː n j ʊ m
ɔ r ɛ f ɪ k ɛ m	aʊ r ɪ f ɪ k ɛ m
b ɛ r ɪ lː ʊ m	b eː r y lː ʊ m
a pː ɛ n d eː r ɛ	a pː ɛ n d ɛ r ɛ
k ɔ m ɛ r k j aː l ɛ	k ɔ mː ɛ r k j aː l ɛ m
t r ɪ w j ʊ m	t r iː b ʊ l ʊ m
a kː a d ɛ m j a m	a k a d eː m iː a m
t ɛ n t aː	t ɛ n t aː r ɛ
s a l aː r j ʊ m	s a l aː r j ʊ m
j uː ɪ t j ʊ m	j uː d ɪ k j ʊ m
b a r b aː r ɪ n zː aː r ɛ	b a r b a r iː zː aː r ɛ
t ɛ s t ɪ m ɔ n j ʊ m	t ɛ s t ɪ m oː n j ʊ m
eː s ɪ t aː r ɛ	h aɪ s ɪ t aː r ɛ
m ɪ s t ɛ lː aː n ɛ ʊ m	m ɪ s k ɛ lː aː n ɛu m
t ɛ rː ɛ m oː t ʊ m	t ɛ rː aɪ m ɔ t ʊ m
eː l ɔ ŋ g ɪ n aː t j oː n ɛ m	eː l ɔ ŋ g aː t j oː n ɛ m
ɪ n s t r ʊ m ɛ n t ɛ l ɛ m	iː n s t r uː m ɛ n t aː l ɛ m
ɛ n k a n ɪ t ɛ r ɛ	ɪ ŋ k aː n eː s k ɛ r ɛ
k ɔ n k aː w ʊ m	k ɔ ŋ k a w ʊ m
a l ɛ g r ʊ m	a l a k r ɛ m
f ɪ d ʊ g ɪ n a m	f iː d uː k j a m
j uː b g ʊ l aː r ɛ	j ʊ g ʊ l aː r ɛ
ɪ n g uː s t ʊ m	ɪ n ɪ uː s t ʊ m
d ɛ n t ɪ f r ɪ k ʊ m	d ɛ n t ɪ f r ɪ k j ʊ m
ɪ n f l ɪ k t j oː n ɛ m	ɪ n f l ɪ k t j oː n ɛ m
a r m aː t ʊ m	a r m aː t ʊ m
ɔ r a r	oː r aː r ɛ
d ɪ s k ʊ rː ɛ r ɛ	d ɪ s k ʊ rː ɛ r ɛ
j uː r ɪ s p r ʊ d a n n ɛ m	j uː r ɪ s p r uː d ɛ n t j a m
k uː ɛ	k uː j ʊ m
p a t r ʊ k iː n j ʊ m	p a t r oː k ɪ n j ʊ m
a t r a m ɛ n t ʊ m	aː t r aː m ɛ n t ʊ m
aɪ s t ɪ pʰ ʊ m	aɪ s t aː t ɛ m
d ɛ n t aː t ʊ m	d ɛ n t aː t ʊ m
ɪ m f ɛ k t aː r ɛ	iː n f ɪ k ɛ r ɛ
s a ɪ t aː r ɛ m	s a g ɪ tː aː r ɛ
s ɛ p t ɛ n t r j ɔ n aː l ɛ	s ɛ p t ɛ n t r j oː n aː l ɛ m
s a k r aː m ɛ n t aː l ɛ m	s a k r aː m ɛ n t aː l ɛ m
f r aː n k eː s ɛ m	f r a ŋ k eː n s ɛ m
a gː r ɛ g aː r ɛ	a gː r ɛ g aː r ɛ
p ɛ r k ʊ t ɛ r ɛ	p ɛ r k ʊ t ɛ r ɛ
aː ɛ h ɔ ɔ s	ɛ kː ʊ m
p r ʊ n ʊ m	p r uː n ʊ m
w ɛ g ɛ t ʊ m	w ɛ g ɛ t ʊ m
m ɛ s ɛ m	m ɛ sː ɛ m
a g r ɪ m ɛ n s oː r ɛ	a g r iː m eː n s oː r ɛ m
t r uː k ʊ l ɛ n t ʊ m	t r ʊ k ʊ l ɛ n t ʊ m
a n ɛ m ʊ n ɛ m	a n ɛ m oː n eː n
p r ɔ l ɔ ŋ g aː r ɛ	p r oː l ɔ ŋ g aː r ɛ
m a r ɪ t aː r ɛ	m a r iː t aː r ɛ
k ɛ n t ʊ r j a m	k ɛ n t ʊ r j a m
r ɔ g ʊ m	r ɔ g ʊ m
ɪ b r ɪ d ʊ m	h y b r ɪ d a m
w a r j ɛ g aː t j oː n ɛ m	w a r ɪ ɛ g aː t j oː n ɛ m
a fː uː m ɪ g aː r ɛ	f uː m ɪ g aː r ɛ
l ɪ k aː t j oː n ɛ m	l ɪ g aː t j oː n ɛ m
k r uː ɛ pʰ t ɛ m t ɛ m	k r uː d eː l ɪ t aː t ɛ m
d ɪ g ɪ t aː l ɛ	d ɪ g ɪ t aː l ɛ m
t uː r b a m	t ʊ r b a m
a b a t j a m	a bː aː t j a m
l ɪ b r aː r ʊ m	l ɪ b r aː r j ʊ m
k a n d oː	k a n d oː r ɛ m
k ɛ r uː l ɛu ʊ m	k aɪ r ʊ l ɛu m
r ɔ g aː r ɛ	r ɔ g aː r ɛ
l ɔ n g ɪ t uː d ɪ n ɛ m	l ɔ ŋ g ɪ t uː d ɪ n ɛ m
ɛ k s p oː r ɛ m	ɛ k s p oː n ɛ r ɛ
m aɪ d ʊ m	m ɛ t ʊ m
a n t a m	a n t aː s
b a r ɪ t ɔ n ʊ m	b a r y t ɔ n ʊ m
d ɪ s p aː r aː r ɛ	d ɪ s p a r aː r ɛ
s p a r g ɛ r ɛ	s p a r g ɛ r ɛ
l uː k j ʊ m	l uː k j ʊ m
m ɛ r ɛ n d a m	m ɛ r ɛ n d a m
a n t ɛ p oː n ɛ r ɛ	a n t ɛ p oː n ɛ r ɛ
f ɛ s t ɪ w ʊ m	f ɛ s t iː w ʊ m
a p aɪ lː ɪ t aː r ɛ	a pː ɛ lː ɪ t aː r ɛ
w ɪ b r aː r ɛ	w ɪ b r aː r ɛ
p ɔ m ɪ f ɛ r ʊ m	p oː m ɪ f ɛ r ʊ m
eː k s p l aː n aː j oː n ɛ m	ɛ k s p l aː n aː t j oː n ɛ m
w ɪ ŋ kʷ ɛ r ɛ	w ɪ ŋ k ɛ r ɛ
m uː n ɪ f ɪ k ʊ m	m uː n ɪ f ɪ k ʊ m
a gː r a w aː r ɛ	a gː r a w aː r ɛ
k ɛ r w ɪ n ʊ m	k ɛ r w iː n ʊ m
k r ɪ m ɪ n aː t j oː n ɛ m	k r iː m ɪ n aː t j oː n ɛ m
a l ɛ a m	aː l ɛ m
t r k ʊ f m ʊ m	t uː b ɛ r
s ɪ eː n ʊ m	s ɪ n ʊ m
ɔ rː ɪ f ɪ k ʊ m	h ɔ rː ɪ f ɪ k ʊ m
ɪ mː a t ʊ r iː t aː t ɛ m	ɪ mː aː t uː r ɪ t aː t ɛ m
p a r ɔ n oː m aː s j a m	p a r ɔ n ɔ m a s j a m
w ɛ r t eː r ɛ	w ɛ r t ɛ r ɛ
ɛ k s t ɛ r m ɪ n a k j oː m	ɛ k s t ɛ r m ɪ n aː t j oː n ɛ m
f uː r ɛ n ʊ m	f uː r ɛ m
d eː l ɪ n kʷ ɛ r ɛ	d eː l ɪ ŋ kʷ ɛ r ɛ
a kː oː m oː d aː t j oː n ɛ m	a kː ɔ mː ɔ d aː t j oː n ɛ m
k ɔ lː k aː r ɛ	k ɔ lː ɔ k aː r ɛ
k ɔ n s oː l iː d aː r ɛ	k oː n s ɔ l ɪ d aː r ɛ
a b s t r ʊ s ʊː m	a b s t r uː s ʊ m
w ɛ r ɪ t aː t ɛ m	w eː r ɪ t aː t ɛ m
ɪ m p r ɛ k aː r ɛ	ɪ m p r ɛ k aː r iː
w ɛ r ɛ k ʊ n d j a m	w ɛ r eː k ʊ n d j a m
a n uː l aː r ɛ m	aː n ʊ l aː r ɛ m
k uː l p aː	k ʊ l p aː r ɛ
f ɛ m ɔ r aː l ɛ	f ɛ m ɔ r aː l ɛ m
m ɛ r d a m	m ɛ r d a m
r a p ɪ r ɛ	r a p ɛ r ɛ
p k j r eː g ʊ n t aː r ɛ	p ɛ r k ɔ n t aː r iː
f ɛ rː uː g t aː r n t ɛ m	f ɛ rː uː g ɪ n ɛ m
p ɛ d ɪ k ɛ lː ʊ m	p ɛ d iː k ɛ lː ʊ m
k ɪ r k ʊ n s k r ɪ b ɛ r ɛ m	k ɪ r k ʊ m s k r iː b ɛ r ɛ
p uː ŋ n aː k ɛ m	p ʊ ŋ n aː k ɛ m
ɛ s t ɪ ʊ m m	aɪ s t iː w ʊ m
a eː r ɔ m a n t j a m	aː ɛ r ɔ m a n t iː a m
a r m a r j ʊ m	a r m aː r j ʊ m
r ɛ k l aː m aː t j oː n ɛ m	r eː k l aː m aː t j oː n ɛ m
d ɪ s k r ɪ m ɪ n aː t j oː n ɛ m	d ɪ s k r iː m ɪ n aː t j oː n ɛ m
f ɛ s t ɪ n aː r ɛ	f ɛ s t iː n aː r ɛ
p ɛ r n ɪ k j oː s ʊ m	p ɛ r n ɪ k j oː s ʊ m
m oː l ɪ n aː r ʊ m	m ɔ l iː n aː r j ʊ m
g a r eː f j ʊ m	g r a pʰ j ʊ m
k ɪ b ɪ k ʊ m	k iː w ɪ k ʊ m
p ɔ r t j oː n ɛ r ʊ m	p ɔ r t aː r j ʊ m
p r ɛ m ɛ r ɛ m	p r ɛ m ɛ r ɛ
n ɔ t r ɪ t a m	n uː t r iː k j ʊ m
g r a t ɪ f k ɛ	g r aː t ɪ f ɪ k aː r iː
b a l t ɪ k ʊ m	b a l t ɪ k ʊ m
aɪ kʷ l ɛ s a m	ɛ kː l eː s j a m
w a g ʊ m	w a g ʊ m
s ɔ n ɔ r ʊ m	s ɔ n oː r ʊ m
s aɪ k ɛ r ɛ n ʊ m	s k r iː p t ʊ m
a k ɛ n d eː r ɛ	a kː ɛ n d ɛ r ɛ
f r uː ɪ r ɛ	f r ʊ iː
ɪ t aɪ r aː r ɛ	ɪ t ɛ r aː r ɛ
f a k s t j ɛ m	f a s k ɛ m
a t ʊ m	aː t ʊ m
a kː w ɪ s iː t j oː n ɛ	a kː w ɪ s iː t j oː n ɛ m
r a p ɪ n a m	r a p iː n a m
s ɔ w k ɛ r ʊ m	s ɔ k ɛ r ʊ m
l ʊ s k ʊ m	l ʊ s k ʊ m
s ɔ l aː r ɛ	s oː l aː r ɛ m
ɪ n g ɛ n ɪ d r aː r ɛ	ɪ ŋ g ɛ n ɛ r aː r ɛ
s ʊ b m ɛ r s j oː n ɛ	s ʊ mː ɛ r s j oː n ɛ m
w ɛ lː ʊ s ʊ m	w ɪ lː oː s ʊ m
s kʷ aː l ʊ m	s kʷ aː l ʊ m
p r oː k r aː s t ɪ n aː r ɛ	p r oː k r aː s t ɪ n aː r ɛ
m a n k ɛ b ʊ m	m a ŋ k ɪ p ɛ m
a ŋ g uː l aː r ɛ	a ŋ g ʊ l aː r ɛ m
f a t ɪ g ɪ n aː r ɛ	f a t iː g aː r ɛ
ɪ t a l j a n ʊ m	iː t a l j aː n ʊ m
t r aː n s f uː g a m	t r aː n s f ʊ g a m
a r b ʊ s t ɪ w ʊ m	a r b ʊ s t iː w ʊ m
g ʊ r t ʊ m	g ʊ r d ʊ m
s t ɪ m ʊ l aː j oː n ɛ m	s t ɪ m ʊ l aː t j oː n ɛ m
l ɪ m ʊ m	l iː m ʊ m
ɪ m p uː l s iː w ʊ m	ɪ m p ʊ l s iː w ʊ m
a r aː n aː t a m	a r aː n ɛ a m
r ɛ p oː n ɛ m	r ɛ p oː n ɛ r ɛ
s p a t aː r ɛ	s p a t j aː r iː
eː k l ɪ p sː ɛ m	ɛ k l iː p s ɛ m
r ɛ p uː b l iː k a m	r ɛ m p uː b l ɪ k a m
p ɛ r t iː sː a m	p ɛ r t ɪ k a m
l ɪ b r ʊ m	l iː b ɛ r ʊ m
ɛ k s k t ʊ t ɛ r ɛ	ɛ k s k ʊ t ɛ r ɛ
ɪ n k ɛ t aː r ɛ	ɪ ŋ k ɛ p t aː r ɛ
r ɛ t ɪ ɛ m	r eː t ɛ
d eː s uː l t oː r j ʊ m	d eː s ʊ l t oː r j ʊ m
uː r n a m	uː r n a m
n uː m ɛ r aː r ʊ m	n ʊ m ɛ r aː r j ʊ m
k ɔ r t ɛ m	k ɔ h ɔ r t ɛ m
m ɔ d ɪ k ʊ m	m ɔ d ɪ k ʊ m
s uː b ɛ r m ʊ m	s uː b ɛ r ɛ m
m ʊ l t ɪ p l ɪ k aː t j oː n ɛ	m ʊ l t ɪ p l ɪ k aː t j oː n ɛ m
m ɔ n t aː n oː s ʊ m	m ɔ n t aː n j oː s ʊ m
t ɔ s oː n ɛ m	t oː n s j oː n ɛ m
k ɔ l p ʊ m	k ɔ l a pʰ ʊ m
a w a l aː n k a m	l aː b iː n a m
k a p a k ɪ t aː t ɛ m	k a p aː k ɪ t aː t ɛ m
uː r b ɛ m	ʊ r b ɛ m
ɔ n oː r ɛ m	h ɔ n oː r ɛ m
m a r s ʊ p j ʊ m	m a r s uː p j ʊ m
a kː uː s aː t oː r j ʊ m	a kː uː s aː t oː r j ʊ m
ɪ mː uː t aː r ɛ	ɪ mː uː t aː r ɛ
k aː m b j aː r ɛ	k a m b iː r ɛ
ɪ n k pʰ d ɛ n ɛ	ɪ ŋ k uː d ɛ m
l a p ɪ d aː t j oː n ɛ m	l a p ɪ d aː t j oː n ɛ m
s ɛ w ɛ r ɪ t aː t ɛ m	s ɛ w eː r ɪ t aː t ɛ m
m a r k ɛ t ʊ m	m a r k ɪ d ʊ m
l f ɪ r oː m	g l iː r ɛ m
f uː n d ɪ b uː l ʊ m	f ʊ n d ɪ b ʊ l ʊ m
w ɔ t ʊ m	w oː t ʊ m
t r ɪ m ʊ l ʊ m	t r ɛ m ʊ l ʊ m
p uː b ɛ m	p uː b ɛ r ɛ m
p ɛ nː uː l a m	p aɪ n ʊ l a m
s ʊ b t ɪ l iː t ɛ m	s ʊ b t iː l ɪ t aː t ɛ m
ɪ m a t ʊ r ʊ m	ɪ mː aː t uː r ʊ m
a ɛ h ɔ aɪ n t aː r ɛ	a lː ɛ k t aː r ɛ
k ɔ n t ɔ r k ɛ r ɛ m	k ɔ n t ɔ r kʷ eː r ɛ
a s t ʊ r ɛ	a s t ʊ r ɛ m
r ɛ k uː s aː t j oː n ɛ m	r ɛ k uː s aː t j oː n ɛ m
r ʊ ɪ ɪ n oː s ʊ m	r ʊ iː n oː s ʊ m
p r ɔ f ɛ r iː r ɛ	p r oː f ɛ rː ɛ
d eː f ɛ k t j oː n ɛ m	d eː f ɛ k t j oː n ɛ m
k ɔ n f oː r m ɛ m	k oː n f oː r m ɛ m
a r m ɪ g iː r ʊ m	a r m ɪ g ɛ r ʊ m
k r ɪ m ɪ n aː l ɛ	k r iː m ɪ n aː l ɛ m
r iː s ʊ m	r iː s ʊ m
r ɛ k uː r s j oː n ɛ m	r ɛ k ʊ r s j oː n ɛ m
p ɔ p ɛ r t aː t ɛ m	p aʊ p ɛ r t aː t ɛ m
p ɛ r p eː t ʊ ɪ t aː t ɛ m	p ɛ r p ɛ t ʊ ɪ t aː t ɛ m
p ɛ r k ɔ rː ɛ r ɛ	p ɛ r k ʊ rː ɛ r ɛ
uː s ɪ t aː	uː s ɪ t aː r iː
aɪ s k ʊ l ʊ m	aɪ s k ʊ l ʊ m
m ʊ w eː r ɛ	m ɔ w eː r ɛ
p r ɛ a k iː r m b ʊ l ʊ m	p r aɪ a m b ʊ l ʊ m
j eː n w ɛ p ʊ eː r ʊ m	j uː n ɪ p ɛ r ʊ m
d ɪ s t ɔ r kʷ ɛ r ɛ	d ɪ s t ɔ r kʷ eː r ɛ
f ɛ r uː l a m	f ɛ r ʊ l a m
k r w k iː r zː r ɛ	k r ʊ oː r ɛ m
f ɛ k ʊ n d ʊ m	f eː k ʊ n d ʊ m
l ɪ m aː r ɛ	l iː m aː r ɛ
a sː ɪ d ʊː m	a sː ɪ d ʊː m
d ɪ l uː ɪ r ɛ	d iː l ʊ ɛ r ɛ
ɛ fː ɛ k t ɪ w ʊ m	ɛ fː ɛ k t iː w ʊ m
r uː g ɪ n ɛ m	aɪ r uː g ɪ n ɛ m
k ʊ k l w r a m	k ɔ l ʊ b r a m
f ʊ l ɪ ʊ g ɪ n ɛ	f uː l iː g ɪ n ɛ m
s uː fː r ʊ t iː k ɛ	s ʊ fː r ʊ t ɪ k ɛ m
w ɪ d uː ɪ t ɛ m	w ɪ d ʊ ɪ t aː t ɛ m
r ɔ r aː r ɛ	r oː r aː r ɛ
w ɛ d aː r iː	w ɪ k ɛ m
k ɔ n s eː l ʊ m	k oː n s ɪ l j ʊ m
r ɛ t r aː k t j oː n ɛ m	r ɛ t r a k t j oː n ɛ m
ɪ n f a n d ʊ m	iː n f a n d ʊ m
f a rː ʊ m	f a rː ɛu m
a pː oː r t aː r ɛ	a pː ɔ r t aː r ɛ
k ɔ m ɛ r ɛ	k ɔ m ɛ d ɛ r ɛ
r uː g iː r ɛ	r uː g iː r ɛ
eː d ɪ f ɪ k aː t j oː n ɛ m	aɪ d ɪ f ɪ k aː t j oː n ɛ m
k ɔ l t r ʊ m	k ʊ l t r ʊ m
r eː s t aʊ r aː r ɛ	r ɛ s t aʊ r aː r ɛ
ɔ r k ɛ s t r a m	ɔ r kʰ eː s t r a m
k ɔ m p ɪ l aː t j oː n ɛ m	k ɔ m p iː l aː t j oː n ɛ m
d ɛ b oː w ɛ r ɛ	d eː w ɔ w eː r ɛ
j uː r a m ɛ n t ʊ m	j uː r aː m ɛ n t ʊ m
n ɪ d ʊ m	n iː d ʊ m
w ɔ m ɪ t aː r ɛ	w ɔ m ɪ t aː r ɛ
r ɛ b ɛ r b ɛ r aː r ɛ	r ɛ w ɛ r b ɛ r aː r ɛ
w eː k ɪ n ɪ t aː t ɛ m	w iː k iː n ɪ t aː t ɛ m
s m ɛ r a l d ʊ m	s m a r a g d ʊ m
t ʊ m	t ʊː m
b a r b s k g ʊ m	b a r b ʊ l a m
m ɔ n aː s t ɛ r j ʊ m	m ɔ n a s t eː r j ʊ m
b ɛ lː ʊ m	b ɛ lː ʊ m
f uː r oː r ɛ	f uː r aː r iː
s t ʊ l t ʊ m	s t ʊ l t ʊ m
r ɛ p l ɪ k aː t j oː n ɛ	r ɛ p l ɪ k aː t j oː n ɛ m
