p iː s t r iː n ʊ m	p ɪ s t r iː n ʊ m
l eː g ɛ r ɛ	l ɛ g ɛ r ɛ
p ɛ n aː t ɪ s	p ɛ n aː t ɛ m
f uː s t ɛ m	f uː s t ɛ m
w ɛ r ɪ f iː k aː r ɛ	w eː r ɪ f ɪ k aː r ɛ
ɛ r ɛ d ɪ r ɛ	h eː r eː d ɪ t aː r ɛ
d aː m b uː l aː t j oː n ɛ m	d ɛ a m b ʊ l aː t j oː n ɛ m
w ɪ t ɛ lː ʊ m	w ɪ t ɛ lː ʊ m
m ɛ n d aː k ɛ m	m ɛ n d aː k ɛ m
g aʊ d ʊ m	g aʊ d j ʊ m
r ɛ f l ʊ iː r ɛ	r ɛ f l ʊ ɛ r ɛ
g uː d ɪ t j aː l ɛ	j uː d ɪ k j aː l ɛ m
k a l ɪ f a m	k a l iː pʰ a m
ɛ t ʊ m	eː t ʊ m
h m ɪ k r aː n j a m	h eː m ɪ k r aː n j a m
b ɔ t ɛ lː ʊ m	b ɔ t ɛ lː ʊ m
s ɪ l ɪ k ʊ m	s ɪ l ɪ k j ʊ m
p ɛ t aː t ʊ m	p ɪ tː a k j ʊ m
ɔ oː p a m	a l a p a m
p ɔ n d ɛ r aː r ɛ	p ɔ n d ɛ r aː r ɛ
t uː g ʊ r j ʊ m	t ʊ g ʊ r j ʊ m
m uː w eː r ɛ	m ɔ w eː r ɛ
d ɛ t ɛ r g ɛ r ɛ	d eː t ɛ r g eː r ɛ
w ɪ k d ɔ w a m	w ɪ d w a m
kʷ ɛ s t j ɔ n aː r j ʊ m	kʷ aɪ s t j oː n aː r j ʊ m
p a d ɪ r ɛ m	p a t r ɛ m
d ʊ k t ʊ m	d ʊ k t ʊ m
kʷ ɛ s ɪ t ʊ m	kʷ aɪ s iː t ʊ m
eː n t ɛ m	ɛ n s
m ɔ t ɪ w ʊ m	m oː t ɪ w ʊ m
b a r aː t r ʊ m	b a r a tʰ r ʊ m
k ɛ r b a m	k ɛ r w a m
k ɔ n f l ʊ ɛ r ɛ	k oː n f l ʊ ɛ r ɛ
s k ʊ r s ʊ m	ɛ k s k ʊ r s ʊ m
p r oː l ɔ kʷ j ʊ m	p r oː l ɔ kʷ j ʊ m
r ɛ k ɛ sː ʊ m	r ɛ k ɛ sː ʊ m
w r ɪ n k ʊ ʊ ʊ m	w ɪ ŋ k ʊ l ʊ m
h l ɪ m ɔ s ɪ n a m	ɛ l ɛ eː m ɔ s y n a m
aɪ g r ɛu m	aɪ g r ʊ m
r aː s k aː r ɛ	r ɛ s ɛ k aː r ɛ
s ɛ k s t ʊ m	s ɛ k s t ʊ m
m a l d ɪ h t j oː n ɛ m	m a l ɛ d ɪ k t j oː n ɛ m
s a l ʊ t aː r ɛ	s a l uː t aː r ɛ m
a n w ʊ m	a nː ʊː m
k ɔ m p ɛ t ɛ r ɛ	k ɔ m p ɛ t ɛ r ɛ
d ɪ s ɛ r t ʊ m	d ɪ s ɛ r t ʊ m
l uː k ʊ b r aː t j oː n ɛ m	l uː k ʊ b r aː t j oː n ɛ m
p ɛ r s ɛ k uː t oː r ɛ	p ɛ r s ɛ k uː t oː r ɛ m
p l aː n ɛ t a m	p l a n eː t a m
ɪ t aː l j a n ʊ m	iː t a l j aː n ʊ m
p a g ʊ r ʊ m	p a g uː r ʊ m
l ɔ k ʊ t j oː n ɛ m	l ɔ k uː t j oː n ɛ m
l ɪ b r aː r ʊ m	l ɪ b r aː r j ʊ m
a sː ɪ b n aː r ɛ	a sː ɪ ŋ n aː r ɛ
k r ɛ d iː t oː r ɛ	k r eː d ɪ t oː r ɛ m
ɛ k s t ɪ r p aː t j oː n ɛ m	ɛ k sː t ɪ r p aː t j oː n ɛ m
g r a d ʊ m	g r a d ʊ m
d ʊ k ɪ r ɛ	d uː k ɛ r ɛ
g ɛ ɔ k r aː f ɪ k ʊ m	g ɛ oː g r a pʰ ɪ k ʊ m
ɪ n d aː g aː r ɛ	ɪ n d aː g aː r ɛ
k ɔ n s ɪ l ʊ m	k oː n s ɪ l j ʊ m
g r aː b aː s ʊ m	g r a b aː t ʊ m
r ɔ b ɪ ʊ ɪ n	r oː b iː g ɪ n ɛ m
p a l oː r ɛ	p a lː oː r ɛ m
a r m ɛ n t ʊ m	a r m ɛ n t ʊ m
d eː s p ɛ t aː r ɛ	d eː s p ɛ k t aː r ɛ
p r ɔ s ɛ n j ɔ s	p r ɔ s k eː n j ʊ m
aɪ s t uː pʰ ʊ m	aɪ s t aː t ɛ m
kʷ ɛ r ɪ m ɔ n j a m	kʷ ɛ r ɪ m oː n j a m
k r aɪ m aː r ɛ	k r ɛ m aː r ɛ
f uː r t ɪ w ʊ m	f uː r t iː w ʊ m
g a r f j ʊ m	g r a pʰ j ʊ m
k a p r ɪ n ʊ m	k a p r iː n ʊ m
a b h eː l ɛ m	aː b ɪ l ɛ m
a b j ʊ r aː r ɛ	a b ɪ uː r aː r ɛ
p ɛ k aː t oː r ɛ	p ɛ kː aː t oː r ɛ m
a l ɪ w j aː r ɛ	a lː ɛ w j aː r ɛ
m a n ɪ f ɛ s t aː r ɛ	m a n ɪ f ɛ s t aː r ɛ
ɔ b s ɛ k j oː s ʊ m	ɔ b s ɛ kʷ j oː s ʊ m
t ɪ s uː k ɪ r a m	t oː n s oː r j ʊ m
a tː ɪ ŋ g ɛ r ɛ	a tː ɪ ŋ g ɛ r ɛ
p ɛ l aː g ʊ m	p ɛ l a g ʊ s
m a l ɛ d iː k ɛ r ɛ	m a l ɛ d iː k ɛ r ɛ
w ɛ s t ɪ t ʊ m	w ɛ s t iː t ʊ m
ɔ b s ɛ d ɛ r ɛ	ɔ b s ɪ d eː r ɛ
p oː ɛ k ʊ n ʊ m	p aʊ k ʊ m
s t aː n j ʊ m	s t a nː ʊ m
m a k s ɪ j oː n aː r ɛ	m a k s ɪ lː a r ɛ m
k a d aː w eː r ɛ	k a d aː w ɛ r
s ʊ j ʊ g aː r ɛ	s ʊ b j ʊ g aː r ɛ
a g r ɛ gʷ aː t j oː n ɛ m	a gː r ɛ g a t j oː n ɛ m
eː k uː l eː t j ʊ m	a k ʊ l ɛu m
n a b eː g aː r ɛ	n aː w ɪ g aː r ɛ
l ʊ k aː r ɛ	g l oː k iː r ɛ
p a k ɪ f ɪ k aː t j oː n ɛ m	p aː k ɪ f ɪ k aː t j oː n ɛ m
ɪ n t ɛ rː ʊ m p ɛ r ɛ	ɪ n t ɛ rː ʊ m p ɛ r ɛ
k ʊ m ɪ n ʊ m	k ʊ m iː n ʊ m
k ɔ n g ʊ r aː r ɛ	k ɔ n ɪ uː r aː r ɛ
k ɔ n d ʊ iː r ɛ m	k ɔ n d uː k ɛ r ɛ
b ɔ t ʊ l iː n ʊ m	b ɔ t ʊ l ʊ m
kʷ a d r ʊ p l ɪ k aː r ɛ	kʷ a d r ʊ p l ɪ k aː r ɛ
p aʊ s a m	p aʊ s a m
ɔ l iː r ɛ	ɔ l eː r ɛ
d eː t ɛ k t aː r j r ɛ	d eː t ɛ g ɛ r ɛ
s p ʊ t aː r ɛ	s p uː t aː r ɛ
f a r ɪ n oː s ʊ m	f a r iː n oː s ʊ m
k eː r t aː r ɛ	k ɛ r t aː r ɛ
j ʊ w ɛ n k ʊ m	j ʊ w ɛ ŋ k ʊ m
s k r ɔ f a m	s k r oː f a m
r ɛ t ɪ n aː k l ʊ m	r ɛ t ɪ n aː k ʊ l ʊ m
s ɛ n s w aː l ɪ t aː t ɛ m	s ɛ n s w aː l ɪ t aː t ɛ m
a b oː m ɪ n aː t j oː n ɛ m	a b oː m ɪ n aː t j oː n ɛ m
t a l p y a m	t a l p a m
b ɛ r ɪ lː ʊ m	b eː r y lː ʊ m
w ɪ t ʊ p eː r aː t j oː n ɛ m	w ɪ t ʊ p ɛ r aː t j oː n ɛ m
b a s t ɛ r n a m	b a s t ɛ r n a m
p a t r j aː r kʰ a m	p a t r j a r kʰ a m
ɪ t oː l aː t ʊ m	iː n s ʊ l aː t ʊ m
s a l w ʊ m	s a l w ʊ m
ɛ s p ɪ r aː r ɛ	s p iː r aː r ɛ
k ɔ kː ɪ n ɪ l a m	k ɔ kː ɪ n a m
ɛ k s ɪ b ɛ r ɛ	ɛ k s h ɪ b eː r ɛ
ɪ n s ɪ n w r ɛ	iː n s ɪ n w aː r ɛ
p r oː s ɛ sː ɪ j r ɛ	p r oː s ɛ kʷ iː
d uː l k aː m aː r a m	d uː l k a m aː r a m
a n aɪ m ɔ n ɛ m	a n ɛ m oː n eː n
p oː m	p j ʊ m
g a lː ʊ m	g a lː ʊ m
aʊ n oː r aː b ɪ l ɛ	h ɔ n oː r aː b ɪ l ɛ m
b ʊ k s ʊ m	b ʊ k s ʊ m
k ɪ t aː r a m	k ɪ tʰ a r a m
r ɛ f r ɪ g eː r j ʊ m	r eː f r iː g ɛ r j ʊ m
m aɪ s t ɪ t ʊ m	m ɪ k s t iː k j ʊ m
k ɔ r ʊ s k aː r ɛ	k ɔ r ʊ s k aː r ɛ
s ʊ p r oː n aː t uː r aː l ɛ m	s ʊ p ɛ r n aː t uː r aː l ɛ m
r a n ʊ k j ʊ m	r aː n ʊ ŋ k ʊ l ʊ m
s a l uː t aː r ɛ	s a l uː t aː r ɛ
a b s k ɪ s ʊ m	a b s k ɪ n d ɛ r ɛ
l ɔ ŋ g aː n iː m ɪ t aː t ɛ m	l ɔ ŋ g a n ɪ m ɪ t aː t ɛ m
s k r ɪ k t uː r a m	s k r iː p t uː r a m
k r oː k oː m	k r ɔ k ʊ m
b a s ɪ l ɪ k ʊ m	b a s ɪ l ɪ k ʊ m
f ɪ g ʊ m	f iː k ʊ m
k oː ŋ g r ʊ m	k ɔ ŋ g r ʊ m
w ɛ t ʊ s t ʊ m	w ɛ t ʊ s t ʊ m
r ɛ kː aː t aː r ɛ	r ɛ k a p t j aː r ɛ
l ɔ m b ʊ m	l ʊ m b ʊ m
m a t ɛ r n iː t ɛ t ɛ m	m aː t ɛ r n ɪ t aː t ɛ m
g r aː w ɪ t aː t j oː n ɛ	g r a w ɪ t aː t j oː n ɛ m
ɪ n k ɛ n d j ʊ m	ɪ ŋ k ɛ n d j ʊ m
p uː b l ɪ k ʊ m	p uː b l ɪ k ʊ m
d ɛ s ɔ l aː r ɛ	d eː s oː l aː r ɛ
p ɛ r k a m	p ɛ r k a m
s t uː ɛ k r a m	s t ɔ r ɛ a m
s k ɪ n t ɪ lː aː r ɛ	s k ɪ n t ɪ lː aː r ɛ
w ɪ s ʊ m s	w iː s ʊ m
a n t ɪ k ɪ p aː r ɛ	a n t ɪ k ɪ p aː r ɛ
k eː l ʊ m	k ɪ l j ʊ m
p ɛ r m ɪ t ɛ r ɛ	p ɛ r m ɪ tː ɛ r ɛ
p a k t ʊ m	p a k t ʊ m
a m aː r ɪ t d ɪ n iː n ɛ	a m aː r ɪ t uː d ɪ n ɛ m
t r aː b aː l ʊ m	t r ɪ p aː l ɛ m
r ɛ g ʊ l aː r ɛ	r eː g ʊ l aː r ɛ m
p ɔ lː aː r j ʊ m	p ʊ lː aː r j ʊ m
t ɛ p ɪ d ʊ m	t ɛ p ɪ d ʊ m
k ɔ r ɛ	kʰ ɔ r eːa m
k ɔ n t r ɪ b ʊ ɛ r ɛ	k ɔ n t r ɪ b ʊ ɛ r ɛ
p a nː ʊ m	p a nː ʊ m
kʷ a d r aː r ɛ	kʷ aː d r aː r ɛ
w ɛ r s ɪ k ʊ l ʊ m	w ɛ r s ɪ k ʊ l ʊ m
s uː b ɪ t aː n ɛ ʊ m	s ʊ b ɪ t aː n ɛu m
m ɛ r k ɛ m	m ɛ r k ɛ m
k r ɪ m ɪ n aː l ɛ	k r iː m ɪ n aː l ɛ m
ɔ r ɪ f ɪ k ɛ m	aʊ r ɪ f ɪ k ɛ m
p l ɔ b j oː s ʊ m	p l ʊ w j oː s ʊ m
p a r t ɪ t j oː n ɛ m	p a r t iː t j oː n ɛ m
f ɔ l ɪ k a m	f ʊ l ɪ k a m
n ɔ ɪ s	n oː s
ɪ n t ɛ r w ɛ n t j oː n ɛ m	ɪ n t ɛ r w ɛ n t j oː n ɛ m
a s p ɔ r t aː r ɛ	a s p ɔ r t aː r ɛ
a b aː t j ɪ aː l ɛ m	a bː aː t j aː l ɛ m
d ɛ r ɪ s j oː n ɛ m	d eː r iː s j oː n ɛ m
d ɛ l ɪ t ʊ m	d eː l ɪ k t ʊ m
s k aː l p ɛ lː ʊ m	s k a l p ɛ lː ʊ m
t ɛ k s t ɪ l ɛ m	t ɛ k s t ɪ l ɛ
p r oː w ɛ n iː r ɛ	p r oː w ɛ n iː r ɛ
ɪ n s ɪ m n j aː r ɛ	iː n s ɪ ŋ n aː r ɛ
b r uː k ʊ m	b r uː kʰ ʊ m
d uː bː j ʊ m	d ʊ b j ʊ m
a kː uː s aː t oː r j ʊ m	a kː uː s aː t oː r j ʊ m
p r ɔ ɪ b iː r ɛ	p r ɔ h ɪ b eː r ɛ
s ɛ p aː r aː r ɛ	s eː p a r aː r ɛ
k ɔ n f ɛ s aː r ɛ	k oː n f ɪ t eː r iː
k ɔ m ɛ t ɛ r ɛ	k ɔ mː ɪ tː ɛ r ɛ
l ɔ l a m	n ɔ t a m
t r aː n s f uː g j a m	t r aː n s f ʊ g a m
p ɛ r n ɪ k oː s ʊ m	p ɛ r n ɪ k j oː s ʊ m
w ɛ k w ʊ r ɛ m	w ɛ lː ɛ r ɛ
p uː j r ɛ	p ʊ t eː r ɛ
f a s t ʊ m	f aː s t ʊ m
w ɛ t r ɪ kʷ ɛ m	w iː t ɪ k ɛ m
j ɛ r aː r k a m	h ɪ ɛ r a r kʰ a m
k ɔ n m ʊ t aː r ɛ	k ɔ mː uː t aː r ɛ
s p ɛ r aː r ɛ	s p eː r aː r ɛ
g ʊ r t ʊ m	g ʊ r d ʊ m
d ɪ f l ʊ ɛ r ɛ	d ɪ fː l ʊ ɛ r ɛ
ɔ b ɛ d j ɛ n t j a m	ɔ b ɔ ɪ d ɪ ɛ n t j a m
l aʊ d ɛ m	l aʊ d ɛ m
r ɛ t aː r d aː r ɛ	r ɛ t a r d aː r ɛ
g ɛ ɔ g r aː f j j a m	g eː ɔ g r a pʰ j a m
s k ɪ r p ʊ m	s k ɪ r p ʊ m
f aɪ b ʊ l ɛ m	f l eː b ɪ l ɛ m
l uː s t r ʊ m	l ʊ s t r ʊ m
a b aː t j a m	a bː aː t j a m
h m w oː r a n ʊ m	w eː r
z aː n k a m	z a ŋ kʰ a m
k ʊ k ʊ ɛ k ʊ m	k ʊ k uː l ʊ m
eː r ʊ m p eː r ɛ	eː r ʊ m p ɛ r ɛ
ɔ l a k r ʊ m	ɔ lː aː r j ʊ m
l ɪ b ɪ r ʊ m	l iː b ɛ r ʊ m
a b l aː k t aː r ɛ	a b l a k t aː r ɛ
p ɔ m ɛ t ʊ m	p ɔ m eː t ʊ m
s a l ʊ b r ɛ m	s a l uː b r ɛ m
p r aɪ w aː l eː r ɛ	p r aɪ w a l eː r ɛ
aɪ l ʊ m	aɪ w ʊ m
w ɪ b r aː t j oː n ɛ m	w ɪ b r aː t j oː n ɛ m
a m ɛ t ɪ s t a m	a m ɛ tʰ y s t a m
k ɔ m p aː r eː t r ɛ	k ɔ m p aː r eː r ɛ
t r aː n s ɪ r ɛ	t r aː n s iː r ɛ
k ɔ n s ʊ l t aː t j oː n ɛ m	k oː n s ʊ l t aː t j oː n ɛ m
g ɛ t aː r ɛ	f eː t aː r ɛ
k ɔ n s ɛ kʷ h ɛ n t j a m	k oː n s ɛ kʷ ɛ n t j a m
s p aː r g ɛ r ɛ	s p a r g ɛ r ɛ
a bː r ɛ w j aː r ɛ	a bː r ɛ w j aː r ɛ
d eː f ɛ k t j oː n ɛ m	d eː f ɛ k t j oː n ɛ m
s a l t aː t j oː n ɛ m	s a l t aː t j oː n ɛ m
l ɪ t aː r ɛ	l ɪ t aː r ɛ
ʊ n ɪ f oː r m ɛ m	uː n ɪ f oː r m ɛ m
d eː t ɛ n t j oː n ɛ m	d eː t ɛ n t j oː n ɛ m
a b l aː k t aː t j oː n ɛ m	a b l a k t aː t j oː n ɛ m
g ɛ l ʊ m	g ɛ l uː
m ɛ r ɪ t ɛ r ɛ	m ɛ r eː r ɛ
d ɛ k ɛ ɛ k t ɔ r j ʊ m	d ɛ k ɛ p t oː r j ʊ m
m uː n ɪ f ɪ k ʊ m	m uː n ɪ f ɪ k ʊ m
w ɛ s t ɪ r ɛ m	w ɛ s t iː r ɛ
r ɛ t r aː k t aː r ɛ	r ɛ t r a k t aː r ɛ
eː k s k ɛ l s ʊ m	ɛ k s k ɛ l s ʊ m
w ɔ l aː r ɛ	w ɔ l aː r ɛ
ɛ k s p l ɪ k aː t j oː n ɛ m	ɛ k s p l ɪ k aː t j oː n ɛ m
d ɪ s p aː r aː m r ɛ	d ɪ s p a r eː r ɛ
a kː r ɛ t j oː n ɛ	a kː r eː t j oː n ɛ m
k oː d ɛ s ʊ m	k l aʊ d ɛ r ɛ
r ɛ t j aː r j ʊ m	r eː t j aː r j ʊ m
s ɔ l ɛ w aː r ɛ	s ʊ b l ɛ w aː r ɛ
p ɛ r ɛ g r iː n aː r ɛ	p ɛ r ɛ g r iː n aː r iː
n ɛ r w oː s ʊ m	n ɛ r w oː s ʊ m
w ʊ l p ɛ m	w ʊ l p ɛ m
k ʊ l m ʊ m	k ʊ l m ʊ m
k a n s aː r ɛ m	k a m p s aː r ɛ
l a w aː t oː r ʊ m	l a w aː t oː r j ʊ m
r ɛ g j ʊ m	r eː g j ʊ m
s ɛ rː aː r ɛ	s ɛ r ɛ r ɛ
s ɪ r w ɛ k ɛ n t ɛ m	s ɛ r w ɪ ɛ n t ɛ m
ɪ m aː k ʊ l aː t ʊ m	ɪ mː a k ʊ l aː t ʊ m
ɪ m p l oː r aː r ɛ	ɪ m p l oː r aː r ɛ
a n n ɛ lː a m	a ŋ n ɛ lː a m
r a p ɪ d ʊ m	r a p ɪ d ʊ m
n a t ʊ m	n aː t ʊ m
p ɛ r t ʊ r b aː t j oː n ɛ m	p ɛ r t ʊ r b aː t j oː n ɛ m
f ɪ d ʊ m	f iː d ʊ m
a j ɪ k j aː k ʊ m	aɪ g y p t j a k ʊ m
a n t ɪ s t ɛ r ɛ m	a n t ɪ s t ɪ t ɛ m
s k ɔ l oː p ɛ n d r a m	s k ɔ l ɔ p ɛ n d r a m
f a a m	f aː g ɛ a m
p a l ʊ m	p aː l ʊ m
p ɛ r p eː t w aː t j oː n ɛ m	p ɛ r p ɛ t w aː t oː n ɛ m
n uː k j ɪ r ɛ m	n ɔ k eː r ɛ
w ɔ l ʊ p t ɛ m	w ɔ l ʊ p t aː t ɛ m
ɪ m p ɔ r t uː n ɪ t aː t ɛ m	ɪ m p ɔ r t uː n ɪ t aː t ɛ m
d eː n ɔ m ɪ n aː t oː r ɛ	d eː n oː m ɪ n aː t oː r ɛ m
r ɛ m ɔ b eː r ɛ	r ɛ m ɔ w eː r ɛ
f a k ʊ d j ɛ m	f aː k ʊ n d j a m
j uː s t ʊ m	j uː s t ʊ m
f a k s t j ɛ m	f a s k ɛ m
ɔ fː ɪ k j ʊ m	ɔ fː ɪ k j ʊ m
a b r ɔ g aː r ɛ	a b r ɔ g aː r ɛ
n ɔ s ɔ k ɔ m j ʊ m	n ɔ s ɔ k ɔ m iː ʊ m
g a rː ɪ r ɛ	g a rː iː r ɛ
p ɔ p ɛ r ʊ m	p aʊ p ɛ r ɛ m
r ɛ s ɛ r w aː t j oː n ɛ m	r ɛ s ɛ r w aː t j oː n ɛ m
n ɛ f a n d ʊ m	n ɛ f a n d ʊ m
l uː b r ɪ k ʊ m	l uː b r ɪ k ʊ m
f uː n ɛ s t ʊ m	f uː n ɛ s t ʊ m
p r aɪ ɔ k ʊ p aː r ɛ	p r aɪ ɔ kː ʊ p aː r ɛ
k ɔ n k t d a m	k oː n s ɔ l ɪ d a m
p ɛ r k oː l aː r ɛ	p ɛ r k oː l aː r ɛ
j ɪ t ʊ m	j a k t ʊ m
eː s t ɛ r n ʊ m	h ɛ s t ɛ r n ʊ m
ɪ n f ɪ r m aː r ɛ	iː n f ɪ r m aː r ɛ
p ɛ r ɪ k ʊ l oː s ʊ m	p ɛ r iː k ʊ l oː s ʊ m
ɪ n f l ʊ ɛ r ɛ	iː n f l ʊ ɛ r ɛ
p l a g j ʊ m	p l a g j ʊ m
a n t aː l ɛ	a m b ʊ l aː r ɛ
p a l ʊ d oː s ʊ m	p a l uː d oː s ʊ m
g uː s t ɪ f iː kʰ aː t oː r ɛ m	j uː s t ɪ f ɪ k aː t oː r ɛ m
s ɛ r w ɪ t ʊ t ɛ m	s ɛ r w ɪ t uː t ɛ m
a n t ɛ n a m	a n t ɛ nː a m
s k ɔ p aː r ɛ	s k ɔ p ɛ r ɛ
a fː eː ɪ k t j oː n ɛ m	a fː ɛ k t j oː n ɛ m
m a a m	m a rː a m
r eː p ʊ d j aː r ɛ	r ɛ p ʊ d j aː r ɛ
f ʊ n d ɪ b uː l ʊ m	f ʊ n d ɪ b ʊ l ʊ m
ɪ n ɛ b r j a r ɛ	ɪ n eː b r j aː r ɛ
a l ɪ j eː n aː r ɛ	a l ɪ eː n aː r ɛ
ɛ kː s k oː r j aː r ɛ	ɛ k s k ɔ r j aː r ɛ
d eː k ɔ r aː r ɛ	d ɛ k ɔ r aː r ɛ
f a y aː l ɛ m	f a k j aː l ɛ m
l uː n aː r ɛ	l uː n aː r ɛ m
k ɔ n g j ʊ m	k ɔ ŋ g j ʊ m
g r aː m aː t iː k aː l ɛ m	g r a mː a t ɪ k aː l ɛ m
m ʊ r a m	m ʊ r j a m
p ɔ p ɛ r t aː t ɛ m	p aʊ p ɛ r t aː t ɛ m
ɛ k s p r iː m ɛ r ɛ	ɛ k s p r ɪ m ɛ r ɛ
b a r b aː t ʊ m	b a r b aː t ʊ m
t r uː k ɛ	t r ʊ k ɛ m
s k aː p ʊ l a m	s k a p ʊ l a m
r ɛ t r ɪ b ʊ ɛ r ɛ	r ɛ t r ɪ b ʊ ɛ r ɛ
s w aː aː w ɛ m	s w aː w ɛ m
s ɛ n s ʊ m	s eː n s ʊ m
a n ɪ h ɪ l aː r ɛ	a nː ɪ h ɪ l aː r ɛ
s k ɔ j ɛ ʊ l oː m	s k ɪ uː r ʊ m
k a l eː r ɛ m	k a l eː r ɛ
t eː m oː r ɛ m	t ɪ m oː r ɛ m
s a n t ʊ m	s aː ŋ k t ʊ m
k eː d ɛ r ɛ	k eː d ɛ r ɛ
a b j ɛ k t j oː n ɛ m	a b ɪ ɛ k t j oː n ɛ m
w ɛ h s aː r ɛ m	w eː k s aː r ɛ
l a k r ɪ m a m	l a k r ɪ m a m
a p l ʊ m	a m p l ʊ m
s uː p ɪ n ʊ m	s ʊ p iː n ʊ m
r ɛ s t aː r ɛ	r ɛ s t aː r ɛ
ɪ m p ɛ r ʊ m	ɪ m p ɛ r j ʊ m
f uː g aː k ɛ	f ʊ g aː k ɛ m
p ɛ r ʊ r ʊ m	p ɛ r ɪ uː r ʊ m
s k uː rː ɪ l ɛ m	s k ʊ rː iː l ɛ m
ɔ n uː s t ʊ m	ɔ n ʊ s t ʊ m
l uː k w ɪ n ɛ l ʊ m	ɛ lː y kʰ n j ʊ m
a b ɛ rː aː r ɛ	a b ɛ rː aː r ɛ
k ɛ r ʊ l ɛu ʊ m	k aɪ r ʊ l ɛu m
a s t r ʊ m	a s t r ʊ m
ɛ k s f oː l j aː r ɛ	ɛ k s f oː l j aː r ɛ
m ɔ d ɛ r aː t oː r ɛ	m ɔ d ɛ r aː t oː r ɛ m
d ɔ m ɛ s t iː k ʊ m	d ɔ m ɛ s t ɪ k ʊ m
n ɔ m ɪ n aː r ɛ	n oː m ɪ n aː r ɛ
a m ɛ n ʊ m	a m ɔ ɪ n ʊ m
k ɔ n k aː k r aː t j oː n ɛ m	k oː n s ɛ k r aː t j oː n ɛ m
w ɛ r sː aː t ɪ l ɛ m	w ɛ r s aː t ɪ l ɛ m
d ɛ b ɛ lː aː r ɛ	d eː b ɛ lː aː r ɛ
b ɔ m b aː r d a m	b ɔ m b a r d a m
k ɪ s t ɛ r n a m	k ɪ s t ɛ r n a m
k ɪ r k ʊ n l oː k uː t j oː n ʊ m	k ɪ r k ʊ m l ɔ k uː t j oː n ɛ m
ɪ n s ɪ n ɛ m	iː n s ɪ ŋ n ɛ m
f ɪ n ɪ k ʊ j ʊ m	f eː n ʊ k ʊ l ʊ m
d ɪ t ʊ m	d ɪ k t ʊ m
p ɪ g oː r ɛ	p ɛ j oː r ɛ m
s a k r aː m ɛ n t aː l ɛ m	s a k r aː m ɛ n t aː l ɛ m
d eː l ɛ k t aː t j oː n ɛ m	d eː l ɛ k t aː t j oː n ɛ m
s ʊ p ɛ r b j ʊ m	s ʊ p ɛ r b ʊ m
k aː l aː r ɛ	k ɔ aː g ʊ l aː r ɛ
l a m a m	l aː m a m
ɔ b s t ɛ t r ɪ k	ɔ b s t ɛ t r iː k ɛ m
d eː s ɛ m n aː r ɛ	d eː s ɪ ŋ n aː r ɛ
p ɛ r ɪ t j a m	p ɛ r iː t j a m
a l ɔ s a	a l aʊ s a m
a r uː s p ɪ k ɛ m	h a r ʊ s p ɪ k ɛ m
m eː l ɛ oː r ɛ	m ɛ l j oː r ɛ m
b ɛ nː j ʊ m	b ɪ ɛ nː j ʊ m
aʊ d ɪ t oː r ɛ m	aʊ d iː t oː r ɛ m
k ʊ l oː n ʊ m	k ɔ l oː n ʊ m
ɔ r b k ɛ m	ɔ r b ɛ m
ɛ w ʊ r oː ʊ m	ɛ b ɔ r ɛu m
k ɔ n k aː w ʊ m	k ɔ ŋ k a w ʊ m
p r aɪ k l aː r ʊ m	p r aɪ k l aː r ʊ m
s uː p l ɛ m s n aː ʊ m	s ʊ pː l eː m ɛ n t ʊ m
a l t aː r ɛ	a l t a r ɛ m
l ɪ m ʊ m	l iː m ʊ m
aɪ m uː l ʊ m	aɪ m ʊ l ʊ m
k ɔ g ɔ ŋ lː ʊ m	k ʊ k ʊ lː ʊ m
p a n ɪ k j uː lː a m	p aː n ɪ k ʊ l a m
n ɛ g oː t j ʊ m	n ɛ g oː t j ʊ m
l ɔ k aː t j oː n ɛ	l ɔ k aː t j oː n ɛ m
m a t ɛ r n ʊ m m	m aː t ɛ r n ʊ m
p a r t ɪ r ɛ	p a r t iː r ɛ
a k t oː r ɛ	aː k t oː r ɛ m
s ʊ m ɛ r g ɛ r ɛ	s ʊ mː ɛ r g ɛ r ɛ
t oː r k ʊ f m ʊ m	t uː b ɛ r
t ʊ rː ŋ ɛ m	t ʊ rː ɛ m
tʰ r a p m ʊ m	d r a pː ʊ m
s kʰ ɪ n t iː pʰ ɪ k ʊ m	s k ɪ ɛ n t ɪ f ɪ k ʊ m
ɪ n t ɛ g r aː r ɛ	ɪ n t ɛ g r aː r ɛ
k ɔ n j ʊ g aː r ɛ	k ɔ n j ʊ g aː r ɛ
s uː ɔ k ɛ r a m	s ɔ k r ʊ m
s s k ʊ m	ɪ s k ʊ m
ɛ k s ɛ k r aː r ɛ	ɛ k sː ɛ k r aː r iː
s k ʊ r t aː r ɛ	k ʊ r t aː r ɛ
m ɪ n ʊ ɪ r ɛ	m ɪ n ʊ ɛ r ɛ
k ɔ n s t ɪ t uː t j oː n ɛ m	k oː n s t ɪ t uː t j oː n ɛ m
p a n ɛ r ɛ m	p aː n aː r j ʊ m
p l uː m a m	p l uː m a m
f r ɪ k t j oː n ɛ m	f r ɪ k t j oː n ɛ m
k ɛ s aː r ɛ	k ɛ sː aː r ɛ
s p ɛ sː ʊ m	s p ɪ sː ʊ m
k ɛ l ɛ b r ɛ m	k ɛ l ɛ b r ɛ m
a kː k ɛ n t ʊ m	a kː ɛ n t ʊ m
k uː rː ɪ k ʊ l ʊ m	k ʊ rː ɪ k ʊ l ʊ m
