r uː g a m	r uː g a m
k ɪ r k ʊ m n aː w eː g aː r ɛ	k ɪ r k ʊ m n aː w ɪ g aː r ɛ
k ʊ k ʊ r m b ɪ t a m	k ʊ k ʊ r b ɪ t a m
s uː p ɪ n ʊ m	s ʊ p iː n ʊ m
d r aː p ɛ m ɛ ʊ m	d r a pː ʊ m
p ɛ n ɪ t ɛ n t j aː l	p aɪ n ɪ t ɛ n t j aː l ɛ m
k a t ɛ k ɪ s m ʊ m	k a t eː kʰ ɪ s m ʊ m
w ɪ k ɪ s ɪ t ʊ d ɪ n ɛ	w ɪ k ɪ sː ɪ t uː d ɪ n ɛ m
t r a m ɪ t ɛ m	t r aː m ɪ t ɛ m
j ɛ n t ɪ l iː t a m t ɛ m	g ɛ n t iː l ɪ t aː t ɛ m
s ɔ m aː r ʊ m	s ʊ mː aː r j ʊ m
p r oː d ʊ k t j oː n ɛ m	p r oː d ʊ k t j oː n ɛ m
f a w oː r ɛ	f a w oː r ɛ m
uː s aː l ɛ	uː s w aː l ɛ m
a b ɛ k aː r ɛ	a d w ɔ k aː r ɛ
p a l ʊ d aː m ɛ n t ʊ m	p a l uː d aː m ɛ n t ʊ m
a sː aː r ɛ	a sː aː r ɛ
k ɔ lː ʊ d ɛ r ɛ	k ɔ lː uː d ɛ r ɛ
r ɛ k ʊ r s j oː n ɛ m	r ɛ k ʊ r s j oː n ɛ m
a rː ɛ m ɛ t aː r	ɪ m ɪ t aː r iː
s ɪ d ɛ r ɛ ʊ m	s iː d ɛ r ɛu m
w ɛ n ɛ r aː t j oː n ɛ m	w ɛ n ɛ r aː t j oː n ɛ m
a d m ɔ n ɪ t j oː n ɛ m	a d m ɔ n ɪ t j oː n ɛ m
p ɛ k aː r ɛ	p aː k aː r ɛ
s a p j ɛ n t a m	s a p ɪ ɛ n t j a m
a b ɪ t ʊ m	h a b ɪ t ʊ m
uː s aː r ɛ	uː t iː
s ʊ s t r ɛ r ɛ m	s ʊ b t r a h ɛ r ɛ
m ɔ l j aː r ɛ	m ɔ lː iː r ɛ
p a s aː j ɛ	p a l ɛ aː r j ʊ m
t r ɪ k ɛ m	t r iː k ɛ m
p l ɔ m b aː r ʊ m	p l ʊ m b aː r j ʊ m
f l aː kː ʊ m	f l a kː ʊ m
l ɪ n aː r ʊ m	l iː n aː r j ʊ m
a ʊ l ʊ	a w j a m
p r eː m ɛ r ɛ	p r ɛ m ɛ r ɛ
p a nː ʊ m	p a nː ʊ m
ɪ n k ɪ t aː t j oː n ɛ m	ɪ ŋ k ɪ t aː t j oː n ɛ m
ɪ t ɛ m p ɛ s t ɪ w oː	ɪ n t ɛ m p ɛ s t iː w ʊ m
k ɔ n d ʊ k iː r ɛ m ɛ m	k ɔ n d uː k ɛ r ɛ
p ɛ r s k r uː t aː r ɛ m	p ɛ r s k r uː t aː r iː
f ɔ r t ɪ f ɪ k aː r ɛ	f ɔ r t ɪ f ɪ k aː r ɛ
s t aː t ʊ m	s t a t ʊ m
f ɛ r ɪ t ɛ m	f ɛ r ɪ t aː t ɛ m
a d uː l aː t oː r ɛ	a d uː l aː t oː r ɛ m
p ɛ s k aː r ʊ m	p ɪ s k aː r j ʊ m
w ɔ r ʊ	w ɔ r ʊ m
k aː t aː r ɛ	k a p t j aː r ɛ
g r uː m ʊ m	g r uː m ʊ m
ɪ m b ɛ k ɪ lː ɪ t aː t ɛ m	ɪ m b eː k ɪ lː ɪ t aː t ɛ m
ɔ l ɛ aː t ʊ m	ɔ l ɛ aː t ʊ m
f ɛ l ɪ k ɛ m	f eː l iː k ɛ m
ɪ t ɔ ɪ n ɛ m	t uː d ɪ n ɛ m
ɪ n k ɛ n s ʊ m	ɪ ŋ k eː n s ʊ m
f a r ɛ s ʊ m	f a r
n uː t r ɪ k aː r ɛ	n uː t r iː k aː r ɛ
k a n s aː r ɛ	k a m p s aː r ɛ
k ɔ m ɛ n t aː r j ʊ m	k ɔ mː ɛ n t aː r j ʊ m
w ɪ d ʊ ɪ t ɛ m	w ɪ d ʊ ɪ t aː t ɛ m
m ɛ r k aː r ɛ m	m ɛ r k aː r iː
t ɛ n j ɛ b r a m	t ɛ n ɛ b r a m
s ɔ n aː r ɛ	s ɔ m n j aː r ɛ
ɪ n uː s ɪ t aː t ʊ m	ɪ n uː s ɪ t aː t ʊ m
p ɪ n t oː r ɛ	p ɪ k t oː r ɛ m
ɛ s p ɪ r aː r ɛ	s p iː r aː r ɛ
a g r ɪ m ɛ n s oː r ɛ	a g r iː m eː n s oː r ɛ m
m ɔ d ʊ l aː r ɛ	m ɔ d ʊ l aː r iː
f l oː r ɪ l ɛ g ʊ m	f l oː r ɪ l ɛ g j ʊ m
k ʊ k ʊ lː a m	k ʊ k ʊ lː a m
p r ɛ m ɪ t j a m s	p r iː m ɪ t j a m
a d m ɪ n ɪ k uː l ʊ m	a d m ɪ n ɪ k ʊ l ʊ m
k uː k ɪ n a m	k ɔ kʷ iː n a m
k ɔ ŋ s r ɛ d aː	k oː n s ɔ l ɪ d a m
k ɔ m uː n ɛ m	k ɔ mː uː n ɛ m
t ɛ n ɛ b r oː s ʊ m	t ɛ n ɛ b r oː s ʊ m
r ɪ k s a m	r ɪ k s a m
s eː g aː r ɛ	s ɛ k aː r ɛ
m ɔ r t aː r j ʊ m	m ɔ r t w aː r j ʊ m
w ɪ t ɛ m a r	w ɪ k t ɪ m aː r ɛ
ɪ eː g l ɛ r ɛ ɛ	a ŋ g l eː n s ɛ m
k a r m ɛ m m	k a r m ɛ n
m a n k ɪ p m j ʊ m	m a ŋ k ɪ p j ʊ m
w ɪ d ɔ w a m	w ɪ d w a m
m uː l ɪ n ʊ m	m ɔ l iː n ʊ m
k a t ɛ d r a m	k a tʰ ɛ d r a m
k a n a m	k a nː a m
w ɪ r g eː n ʊ m	w ɪ r g ɪ n ɛ m
g a w ɛ t a m	g a b a t a m
oː rː ɪ	h ɔ rː eː r ɛ
s ʊ mː ʊ m	s ʊ mː ʊ m
a b aː l iː ɛ n aː t j oː n ɛ m	a b a l ɪ eː n aː t j oː n ɛ m
k ɔ m ʊ n aː l	k ɔ mː uː n aː l ɛ m
d eː n ʊ d aː r ɛ	d eː n uː d aː r ɛ
k ɪ k ʊ t a m	k ɪ k uː t a m
ʊ z s k w oː	uː ŋ k t j oː n ɛ m
a b n oː r m ɛ m	a b n oː r m ɛ m
ɪ ŋ n ɔ r aː r ɛ	ɪ ŋ n oː r aː r ɛ
f r b j ɪ g ɪ d aː t ɛ m	f r iː g ɪ d ɪ t aː t ɛ m
t r uː k ɪ d aː r ɛ	t r ʊ k iː d aː r ɛ
b ŋ aː a t ʊ m	b ɔ aː t ʊ m
ɛ k s p ɛ n d ɛ r ɛ	ɛ k s p ɛ n d ɛ r ɛ
ɛ k s ɛ k r aː r ɛ	ɛ k sː ɛ k r aː r iː
s eː d aː r ɛ	s eː d aː r ɛ
k a p ɪ t aː t j oː n ɛ m	k a p ɪ t aː t j oː n ɛ m
h ɪ k ɪ	kʷ ɛ m
g ɛ l ʊ m	g ɛ l uː
l ʊ k iː b r g aː r m	l uː k ʊ b r aː r ɛ
a b d ʊ k ɛ r	a b d uː k ɛ r ɛ
r ɪ n ʊ k ʊ l ɛ m ʊ m	r aː n ʊ ŋ k ʊ l ʊ m
k ɔ k ʊ m	k ɔ kʷ ʊ m
t ɛ rː ɛ m oː t ʊ m	t ɛ rː aɪ m ɔ t ʊ m
a m a r kʷ aː r ɛ	a m aː r ɪ k aː r ɛ
eː m uː ŋ g eː r ɛ	eː m ʊ ŋ g ɛ r ɛ
m ɔ d ɛ r aː r ɛ	m ɔ d ɛ r aː r iː
a k ɪ n ʊ m	a k ɪ n ʊ m
w ʊ l t ʊ m	w ʊ l t ʊ m
p ʊ n t ʊ m	p uː ŋ k t ʊ m
k a m ɪ n ʊ m	k a m iː n ʊ m
t ɔ r k ɛ r ɛ m	t ɔ r kʷ eː r ɛ
f ɛ m ɪ n a m	f eː m ɪ n a m
l ɪ m oː s ʊ m	l iː m oː s ʊ m
k ɔ n t ʊ r b aː t j oː n ɛ m	k ɔ n t ʊ r b aː t j oː n ɛ m
a nː ɛ g aː r ɛ	eː n ɛ k aː r ɛ
p uː s t ʊ l a m	p ʊ s t ʊ l a m
k ɔ n s t r iː k tː oː r ɛ	k oː n s t r ɪ k t oː r ɛ m
m eː n s a m	m eː n s a m
a d oː r aː t j oː n ɛ m	a d oː r aː t j oː n ɛ m
g ɛ r m aː n ɪ k ʊ m	g ɛ r m aː n ɪ k ʊ m
a tː r ɪ b ʊ ɪ r ɛ	a tː r ɪ b ʊ ɛ r ɛ
m ɛ n d ɪ k aː r ɛ	m ɛ n d iː k aː r ɛ
r ɛ k ʊ s aː r ɛ	r ɛ k uː s aː r ɛ
kʷ a l ɪ f iː k aː r ɛ	kʷ aː l ɪ f ɪ k aː r ɛ
k ɔ l t r ʊ m	k ʊ l t r ʊ m
k ʊ l t ɛ lː ʊ m	k ʊ l t ɛ lː ʊ m
a s k ɛ n d ɛ r ɛ	a s k ɛ n d ɛ r ɛ
l a t ʊ m	l aː t ʊ m
ɪ n d ɔ l ɛ m	ɪ n d ɔ l ɛ m
ɛ r iː m aː n d aː t ɛ m	g ɛ r m aː n ɪ t aː t ɛ m
r ɛ l a t ɪ w ʊ m	r ɛ l aː t iː w ʊ m
k a n ɔ r ʊ m	k a n oː r ʊ m
n ɛ f aː r j ʊ m	n ɛ f aː r j ʊ m
s t r aː g ʊ m	s t r aː g ɛ m
d eː f ɛ n s oː r ɛ	d eː f eː n s oː r ɛ m
d ɔ r m iː t oː r j ʊ m	d ɔ r m iː t oː r j ʊ m
ɛ m l ɪ m ɔ m ɪ n a m	ɛ l ɛ eː m ɔ s y n a m
f ɛ r w ɛ r ɛ	f ɛ r w eː r ɛ
s k a l j aː r ɛ	s k aː l aː r ɛ m
a t ɪ n eː r ɛ	a tː ɪ n eː r ɛ
w ɪ n ɛ t ʊ m	w iː n eː t ʊ m
n ɪ d ʊ m	n iː d ʊ m
g l aʊ k ʊ m	g l aʊ k ʊ m
k ɔ n k ɪ l j aː b ʊ l ʊ m	k ɔ ŋ k ɪ l j aː b ʊ l ʊ m
r ɪ l ʊ r ɛ ɛ r ɛ	r ɛ l uː k eː r ɛ
l a w aː t oː r j ʊ m	l a w aː t oː r j ʊ m
p l aː n g ɛ r ɛ	p l a ŋ g ɛ r ɛ
a fː ɛ k t ʊ m	a fː ɛ k t ʊ m
k r ɔ t aː l ʊ m	k r ɔ t a l ʊ m
w ɔ ŋ l ʊ n t aː t ɛ m	w ɔ l ʊ n t aː t ɛ m
a t ʊ m	aː t ʊ m
eː m ɛ r g ɛ r ɛ	eː m ɛ r g ɛ r ɛ
n ɪ d aː	n oː d aː r ɛ
j ɛ n ɪ t ɪ b ʊ m	g ɛ n ɪ t iː w ʊ m
k ɔ m p ɛ t ɛ n t j a m	k ɔ m p ɛ t ɛ n t j a m
k a s t r ʊ m	k a s t r ʊ m
m a kː j aː r ɛ	m a k ʊ l aː r ɛ
m ɛ d ɪ k aː r ɛ	m ɛ d ɪ k aː r ɛ
a kː ɪ d j a m	a k eː d j a m
s t ɪ m ʊ l aː t j oː n ɛ m	s t ɪ m ʊ l aː t j oː n ɛ m
m ɔ n ɛ d aː	m ɔ n eː t a m
d ɛ l t aː t ɛ m	d ɛ ɪ t aː t ɛ m
r ɛ k ɛ p t aː r ɛ	r ɛ k ɛ p t aː r ɛ
s ɛ rː ɛ g ɪ n	s ɛ rː aː g ɪ n ɛ m
a n aː l ɪ s iː	a n a l y s ɛ m
t uː g ʊ r j ʊ m	t ʊ g ʊ r j ʊ m
p r aɪ s ɛ n t aː t j oː n ɛ m	p r aɪ s ɛ n t aː t j oː n ɛ m
k a l ɪ k ɛ m	k a l ɪ k ɛ m
g a t ʊ m a	g a n aː r ɛ
l ɪ b ɛ l ʊ m	l ɪ b ɛ lː ʊ m
f ɔ m ɛ n t ʊ m	f oː m ɛ n t ʊ m
oː w eː g a m	ɔ w ɪ k ʊ l a m
p eː p ɛ m r ɛ	p ɪ p ɛ r
a l ɛ t r ɛ	a lː ɛ k t aː r ɛ
ɪ n k ɔ m oː d aː r ɛ	ɪ ŋ k ɔ mː ɔ d aː r ɛ
p ʊ t aː r ɪ m	p ʊ t aː r ɛ
s eː p ʊ lː k aː r ɛ	s ɛ p ɛ l iː r ɛ
p ʊ l p m ʊ m	p ɔ l y p ʊ m
s ʊ b r ɛ w eː n ɪ r	s ʊ p ɛ r w ɛ n iː r ɛ
a n aː l ɛ	aː n aː l ɛ m
d eː f ɛ n s j oː n ɛ m	d eː f eː n s j oː n ɛ m
b ɛ lː ʊ m	b ɛ lː ʊ m
r ɛ m ɛ m b r aː r ɛ	r ɛ m ɛ m ɔ r aː r iː
r eː m ʊ m	r eː m ʊ m
ɪ l ɛ	ɪ l ɛ m
k ɔ lː ɛ g j ʊ m	k ɔ lː eː g j ʊ m
t r aː n s ɪ t ʊ m	t r aː n s ɪ t ʊ m
r ɛ w ɔ k aː r ɛ	r ɛ w ɔ k aː r ɛ
s a t ʊ r aː r ɛ	s a t ʊ r aː r ɛ
p a l p ɛ b r aː l	p a l p ɛ b r aː l ɛ m
s ɪ b lː ʊ aː r ɛ	s iː b ɪ l aː r ɛ
p r uː d ɛ r ɛ	p r uː r iː r ɛ
k ɪ ɔ n kʷ ɛ k	kʷ ɛ m k ʊ m kʷ ɛ
s a k r aː ɛ	s a k r aː r ɛ
w ɛ s t ɪ r ɛ	w ɛ s t iː r ɛ
f ɛ m ʊ r ɛ	f ɛ m ʊ r
k a p aː k ɛ	k a p aː k ɛ m
p r oː t ɛ r w ʊ m	p r ɔ t ɛ r w ʊ m
k ɔ ŋ d ɪ ŋ n ʊ m	k ɔ n d ɪ ŋ n ʊ m
uː r b ɛ m	ʊ r b ɛ m
n ɪ d ɪ f oː r m ɛ	n iː d ɪ f oː r m ɛ m
w a d oː s ʊ m	w a d oː s ʊ m
m a n s ʊ m n ɛ m	m aː n s j oː n ɛ m
a l ɛ n t ʊ m	a n h eː l ɪ t ʊ m
t r ɪ p l ʊ m	t r ɪ p l ʊ m
s a kʷ uː d ɛ r	s ʊ kː ʊ t ɛ r ɛ
l aː k t aː r j ʊ m	l a k t aː r j ʊ m
k uː m ʊ l aː r ɛ	k ʊ m ʊ l aː r ɛ
p uː l p ɪ t m ʊ m	p ʊ l p ɪ t ʊ m
d eː l ɪ b ɛ r aː t j oː n ɛ m	d eː l iː b ɛ r aː t j oː n ɛ m
p r aɪ k oː n ʊ t ɛ r ɛ	p r aɪ k ɔ ŋ n ɔ s k ɛ r ɛ
ɪ n g ʊ m t j ʊ m n ɛ m	ɪ n j ʊ ŋ k t j oː n ɛ m
k ɪ p r ɛ m a m	k ʊ p r ɛ sː ʊ m
m a k l ʊ m m	m a s k ʊ l ʊ m
t a m ɪ ʊ m	t a m ɪ s j ʊ m
uː l t ɛ r j oː r ɛ	ʊ l t ɛ r j oː r ɛ m
p r oː t ɛ s t aː t j oː n ɛ m	p r oː t ɛ s t aː t j oː n ɛ m
s a t ɪ r ʊ m	s a t y r ʊ m
ɪ mː ɪ s t ɛ r ɛ s ɛ	ɪ mː ɪ s k eː r ɛ
r ɪ n ɛ m	r eː n ɛ m
r ɛ t oː r	r h eː t ɔ r ɛ m
ɪ n w ɛ r t ɛ r ɛ	ɪ n w ɛ r t ɛ r ɛ
ɔ r ɪ g ɪ n aː r j ʊ m	ɔ r iː g ɪ n aː r j ʊ m
b ɪ s k a m	b eː s t j a m
p r oː s ɛ k ɪ k r ɛ	p r oː s ɛ kʷ iː
a k a m	a k j a m
ɪ n d ɪ g n iː t aː t ɛ m	ɪ n d ɪ ŋ n ɪ t aː t ɛ m
f ɪ s k ʊ m	f ɪ s k ʊ m
p l aː k ɪ d ʊ m	p l a k ɪ d ʊ m
b ɛ l aː r j t ɛ m	b eː l w a m
p ɔ l ʊ m	p ɔ l ʊ m
oː s k ʊ l ʊ m	oː s k ʊ l ʊ m
k ɔ kʷ ɛ	k ɔ kː ʊ m
a r k a ŋ g ɛ l ʊ m	a r kʰ a ŋ g ɛ l ʊ m
n a w ɪ m	n aː w ɪ g j ʊ m
l ɛ k t oː r ɛ	l eː k t oː r ɛ m
l ɔ ɛ r ʊ m	l uː r ɪ d ʊ m
w ɛ n t ʊ m	w ɛ n t ʊ m
ɪ n f ɛ k t aː r ɛ	iː n f ɪ k ɛ r ɛ
f uː n ɪ k ʊ l ʊ m	f uː n ɪ k ʊ l ʊ m
a r k ɪ b ɪ s k ɛ p ʊ m	a r kʰ ɪ ɛ p ɪ s k ɔ p ʊ m
d ɛ r ʊ m p ɛ ɛ	d iː r ʊ m p ɛ r ɛ
a k k ɛ s ʊ m	a kː ɛ sː ʊ m
m ɛ r k ɛ m	m ɛ r k ɛ m
p r oː d ɪ j oː s ʊ m	p r oː d ɪ g j oː s ʊ m
d ɪ s k r eː t j oː n ɛ	d ɪ s k r eː t j oː n ɛ m
s ɛ g aː l ɛ m	s ɛ k aː l ɛ
l ɪ t ɛ m	l iː t ɛ m
ɪ n f l aː m aː t j oː n ɛ m	iː n f l a mː aː t j oː n ɛ m
k ɔ n m ʊ ɛ w ɛ r ɛ	k ɔ mː ɔ w eː r ɛ
a n t ɪ k ɪ p aː r ɛ	a n t ɪ k ɪ p aː r ɛ
f ɛ r a m	f ɛ r a m
a d ɪ t ʊ m	a d ɪ t ʊ m
f ʊ r ʊ n k ʊ l ʊ m	f uː r ʊ ŋ k ʊ l ʊ m
ɪ n ʊ m	iː n ʊ m
b a p t ɪ s t ɛ r j ʊ m	b a p t ɪ s t eː r j ʊ m
a l oː s	a l aʊ s a m
p a s aː r ʊ m	p a sː ɛ r ɛ m
oː	ʊ m
s a l w ʊ m	s a l w ʊ m
d eː s ɪ d j a m	d eː s ɪ d j a m
g uː b ʊ l a m	z iː z y pʰ ʊ m
k ʊ l oː n ʊ m	k ɔ l oː n ʊ m
sː t aː p ɛ s ɛ	s t a p ɛ d ɛ m
l ɪ g a m ɛ n t ʊ m	l ɪ g aː m ɛ n t ʊ m
a m oː w ɪ b ɪ l ɛ	aː m ɔ w eː r ɛ
t r ɪ b uː t ʊ m	t r ɪ b uː t ʊ m
p ɛ r m aː n eː t ɛ r ɛ	p ɛ r m a n eː r ɛ
s ɛ r ɛ n aː r ɛ	s ɛ r eː n aː r ɛ
t eː m oː r ɛ m	t ɪ m oː r ɛ m
s ɔ l ʊ m	s ɔ l ʊ m
r ɛ w ɛ r b ɛ r ɛ r ɛ	r ɛ w ɛ r b ɛ r aː r ɛ
r ɛ k ɔ n k iː l j aː r ɛ	r ɛ k ɔ ŋ k ɪ l j aː r ɛ
t uː n k ɛ r ɛ	t ʊ n d ɛ r ɛ
uː l k ɛ r a m	ʊ l k ʊ s
ɪ n kʷ j eː t uː d ɪ n ɛ m	ɪ ŋ kʷ ɪ eː t uː d ɪ n ɛ m
s a ŋ k j oː n ɛ m	s aː ŋ k t j oː n ɛ m
oː n d aː r ɛ	ʊ n d aː r ɛ
t r a m a m	t r aː m a m
r ɛ s t a m	r ɛ s t ɛ m
k ɔ sː ʊ	k ɔ sː ʊ m
k ɔ r s ʊ m	k ɔ r s ʊ m
a l w ɛ r ʊ m	a l b aː r j ʊ m
m a r t ɛ lː ʊ m	m a r t ɛ lː ʊ m
s ɪ t j ʊ m	s ɪ t ʊ m
a g r ɛ s t ɛ m	a g r ɛ s t ɛ m
f ɪ j aː r ɛ	f iː d ɛ r ɛ
d ɔ m ɪ n ɪ k aː l ɛ m	d ɔ m ɪ n ɪ k aː l ɛ m
f r ɪ k t j oː n ɛ m	f r ɪ k t j oː n ɛ m
ɪ t ɪ n ɛ r aː r j ʊ m	ɪ t ɪ n ɛ r aː r j ʊ m
t ɪ s ɪ k ʊ m	p eː h tʰ ɪ s ɪ k ʊ m
p ɛ n ɛ t r aː r	p ɛ n ɛ t r aː r ɛ
a nː ɪ k ɪ l aː r ɛ	a nː ɪ h ɪ l aː r ɛ
t r aː n s g r ɛ d iː r ɛ	t r aː n s g r ɛ d iː
t ʊ s ʊ m	t oː n s ʊ m
d eː k aː l w aː t j oː n ɛ m	d eː k a l w aː t j oː n ɛ m
b a s ɪ l ɪ k ʊ m	b a s ɪ l ɪ k ʊ m
s k aː b j a m	s k a b ɪ ɛ m
r ɔ t aː r ɛ	r ɔ t aː r ɛ
r ɔ m ɛ k ɛ m	r ʊ m ɪ k ɛ m
p ɛ t aː t ʊ m	p ɪ tː a k j ʊ m
s p oː ŋ g a m	s p ɔ ŋ g j a m
l a b ʊ r aː t oː r ɛ	l a b oː r aː t oː r ɛ m
l ʊ p a m	l ʊ p a m
f ɛ n ɪ k j ʊ m	pʰ ɔ ɪ n iː k ɛu m
ɪ d ɛ n t ɪ k ʊ m	iː d ɛ n t ɪ k ʊ m
p a n ɪ k uː l	p aː n ɪ k ʊ l a m
f ɪ r ɛ m	f ɪ ɛ r iː
t j ɛ r t j ʊ m	t ɛ r t j ʊ m
a r g ɛ n t oː s ʊ m	a r g ɛ n t oː s ʊ m
m uː k oː s ʊ m	m uː k oː s ʊ m
s t aː t ɛ r a m	s t a t eː r a m
m a r ɪ t aː r ɛ	m a r iː t aː r ɛ
r eː w ɔ l w ɛ r ɛ	r ɛ w ɔ l w ɛ r ɛ
s ɔ l ɪ d aː r ɛ	s ɔ l ɪ d aː r ɛ
t r aː n s p ɔ r t aː r ɛ	t r aː n s p ɔ r t aː r ɛ
d eː n ʊ n ɛ m t j aː t j ɛ m n	d eː n ʊ n t j aː t j oː n ɛ m
ɪ t aː t ɛ m	ɪ t aː t ɛ m
j ʊ d ɛ t j ʊ m	j uː d ɪ k j ʊ m
p ɛ r m ɪ t ɛ r ɛ	p ɛ r m ɪ tː ɛ r ɛ
r uː k ʊ m	r oː s k ɪ d ʊ m
a sː uː m ɛ r ɛ	a sː uː m ɛ r ɛ
k ɔ d ɪ k ɛ m	k oː d ɪ k ɛ m
p ɛ r ɪ k l iː t aː r ɛ	p ɛ r iː k l ɪ t aː r iː
g ɛ r uː n d j ʊ m	g ɛ r ʊ n d j ʊ m
a d w ɛ r b j aː l ɛ	a d w ɛ r b j aː l ɛ m
k ɔ k ɔ m ɛ b r ʊ m	k ʊ k ʊ m ɛ r ɛ m
r ɛ s k ɪ n d ɛ r ɛ	r ɛ s k ɪ n d ɛ r ɛ
p l aː n t ʊ m	p l a ŋ k t ʊ m
f k ʊ r t aː r ɛ	k ʊ r t aː r ɛ
k oː n g r j ʊ m	k ɔ ŋ g r ʊ m
h ɪ s p aː n iː k ʊ m	h ɪ s p aː n ɪ k ʊ m
d ɪ f l ʊ ɛ r	d ɪ fː l ʊ ɛ r ɛ
p a s t a m	p a s t a m
kʷ ɛ r m ɛ k ɛ m	kʷ ɛ r k ʊ m
g a lː ɪ t a m	g a lː ɛ t a m
n ɪ w ɛ lː ʊ m	l iː b ɛ lː a m
k ʊ ɪ r ʊ m	k ɔ r j ʊ m
s uː p ʊ t aː r	s ʊ pː ʊ t aː r ɛ
a l a m	aː l ɛ m
a b oː l ɪ t j oː n ɛ m	a b ɔ l ɪ t j oː n ɛ m
p r aɪ d j aː l ɛ	p r aɪ d j aː l ɛ m
ɔ pː oː n r ɛ	ɔ pː oː n ɛ r ɛ
s ɔ l ɛ r ɛ	s ɔ l eː r ɛ
s uː p ɛ r b aː k aː n ɪ ʊ m	s ʊ p ɛ r w a k ʊː m
a r k a m	a r kʰ a m
k ɔ m p ɛ t ɛ r ɛ	k ɔ m p ɛ t ɛ r ɛ
d uː r aː k ɪ n ʊ m	d uː r a k ɪ n ʊ m
k ɪ r k ʊ n s k r iː w ɛ r ɛ m	k ɪ r k ʊ m s k r iː b ɛ r ɛ
f aɪ d ɛ	f ɪ d ɛ m
r ɪ k t ʊ r	r ɪ k t ʊ m
s ɛ r a m	s ɛ rː a m
t ɔ r m ɛ n t ʊ m	t ɔ r m ɛ n t ʊ m
k a n eː s t aː ʊ m	k a n ɪ s t r ʊ m
a nː aɪ l ʊ m	a nː ɪ k ʊ l ʊ m
k ɔ n d ʊ k t j oː n ɛ m	k ɔ n d ʊ k t j oː n ɛ m
ɪ n d ɪ g ɛ n t aː	ɪ n d ɪ g ɛ n t j a m
p r aɪ t ɛ n d ɛ r ɛ	p r aɪ t ɛ n d ɛ r ɛ
p r aɪ k l aː r ʊ m	p r aɪ k l aː r ʊ m
a r k j a m	a r kʰ j a m
s ɔ n t ɛ m	s ɔ n t ɛ m
w ʊ l p ɪ n ʊ m	w ʊ l p iː n ʊ m
p oː	p j ʊ m
p r oː k aː k ɛ	p r ɔ k aː k ɛ m
a pː ɛ l ɪ t aː r	a pː ɛ lː ɪ t aː r ɛ
w ɔ ɪ s	w oː s
k l aː t oː l ʊ m	g l a d ɪ ɔ l ʊ m
p uː n aː r ɛ	p ʊ ŋ n aː r ɛ
a s ɪ l ʊ m	a s y l ʊ m
b l aː t ɛ r aː r ɛ	b l a t ɛ r aː r ɛ
kʷ ɪ n t ʊ m	kʷ iː n t ʊ m
s ʊ s t ɛ k n t aː k ʊ l ʊ m	s ʊ s t ɛ n t aː k ʊ l ʊ m
m ɪ l ɪ t ɛ m	m iː l ɪ t ɛ m
a fː ʊ r aː r	aʊ f ɛ rː ɛ
ɪ n s ɪ n ɛ m	iː n s ɪ ŋ n ɛ m
k eː r t aː r ɛ	k ɛ r t aː r ɛ
eː fː aɪ k t aː ɛ r ɛ	ɛ fː ɪ k ɛ r ɛ
a n t ɛ n a m	a n t ɛ nː a m
eː k s p ɛ m t aː t j oː n ɛ m	ɛ k sː p ɛ k t aː t j oː n ɛ m
s k r ɔ f a m	s k r oː f a m
d eː s ɛ r t j oː n ɛ m	d eː s ɛ r t j oː n ɛ m
k ɔ m ɛ t ɛ r ɛ	k ɔ mː ɪ tː ɛ r ɛ
l ɛ n aː r	l ɪ ŋ n aː r iː
k ɔ k ɪ n ɪ lː a m	k ɔ kː ɪ n a m
p r oː s ɛ n j ɔ m	p r ɔ s k eː n j ʊ m
t ɛ rː ɛ ʊ m	t ɛ rː ɛu m
l uː k ʊ b r aː t j oː n	l uː k ʊ b r aː t j oː n ɛ m
k r ɪ m ɪ n aː t j oː n	k r iː m ɪ n aː t j oː n ɛ m
s ɛ p ɛ m	s aɪ p ɛ m
n a s a m	n a sː a m
a sː ɪ s t ɛ r ɛ	a sː ɪ s t ɛ r ɛ
m a kː w ʊ s ʊ m	m a k ʊ l oː s ʊ m
uː s p ɛ d aː r ɛ m	h ɔ s p ɪ t aː r iː
ɛ k s p r iː m ɛ r ɛ	ɛ k s p r ɪ m ɛ r ɛ
k ɔ n s ɪ l j ʊ m	k oː n s ɪ l j ʊ m
k ɛ n aː k t l ʊ m	k eː n aː k ʊ l ʊ m
k ɔ n k ɪ t aː t j oː n ɛ m	k ɔ ŋ k ɪ t aː t j oː n ɛ m
n ɛ s p ɛ l a m	m ɛ s p ɪ l ʊ m
d ɪ s p aː r eː r ɛ	d ɪ s p a r eː r ɛ
k a p r ʊ m n	k a p r ʊ m
a b n ɛ g aː r ɛ	a b n ɛ g aː r ɛ
eː k s t ɛ n d ɛ r ɛ	ɛ k s t ɛ n d ɛ r ɛ
m ɛ r ɪ t aː r ɛ	m ɛ r iː d j aː r ɛ
p r ɛ s aː g j aː r ɛ	p r aɪ s aː g iː r ɛ
k ɔ l ʊ b r iː n ʊ m	k ɔ l ʊ b r iː n ʊ m
w a n ɪ	w a nː ʊ m
k ɪ t ɪ s ʊ m	k y t ɪ s ʊ m
