f r ɔ n t ʊ m n ɛ m	f r ɔ n t oː n ɛ m
k ɔ n w ɛ n ɪ r ɛ	k ɔ n w ɛ n iː r ɛ
g eː n t ɪ l ɪ t a m	g ɛ n t iː l ɪ t aː t ɛ m
ɔ s t ɛ n t aː r ɛ	ɔ s t ɛ n t aː r ɛ
n a rː aː r ɛ	n a rː aː r ɛ
pː a l j ʊ r ʊ m	p a l ɪ uː r ʊ m
f ʊ n d a m ɛ n t ʊ m	f ʊ n d aː m ɛ n t ʊ m
a r k a n ʊ m	a r k a n ʊ m
s ɛ	s eː
r ɛ f l ʊ iː r ɛ	r ɛ f l ʊ ɛ r ɛ
a pː ɔ n ɛ m	a pː oː n ɛ r ɛ
a s t ʊ t ʊ m	a s t uː t ʊ m
m a n ɪ f j ɛ s t ʊ m	m a n ɪ f ɛ s t ʊ m
p ɔ r t ɪ ɛ r ʊ m	p ɔ r t aː r j ʊ m
ɛ s k ɔ aː t ɛ m r ɛ	ɛ k s k ɔ kʷ ɛ r ɛ
a b r eː w j a t j ʊ m n ɛ m	a bː r ɛ w j aː t j oː n ɛ m
k aː t aː r ɛ	k ɔ a k t aː r ɛ
a b g ʊ r a t j oː n	a b ɪ uː r aː t j oː n ɛ m
ɪ lː ʊ d ɪ r	ɪ lː uː d ɛ r ɛ
ɪ m mː ɔ l a t j ʊ m n ɛ m	ɪ mː ɔ l aː t j oː n ɛ m
eː f ɪ k a t ɪ t aː	ɛ fː ɪ k aː k ɪ t aː t ɛ m
t ɛ n ɛ b r ɛ m	t ɛ n ɛ b r aː s
ɪ lː a t j ʊ m n ɛ m	ɪ lː aː t j oː n ɛ m
a b aɪ t ɛ m	a b ɪ eː t ɛ m
m a l ɛ	m a l ʊ m
m ɛ n d aː k ɛ m	m ɛ n d aː k ɛ m
p aː r t ʊ m	p a r t ʊ m
k ɔ n f ɔ r m ɛ m	k oː n f oː r m ɛ m
ɪ n w ɪ t aː r ɛ	ɪ n w iː t aː r ɛ
s eː kʷ aː k ɛ	s ɛ kʷ aː k ɛ m
k a w a l ɪ ɛ r	k a b a lː aː r j ʊ m
a n t r ʊ m	a n t r ʊ m
p eː r ɪ k l ɪ t aː r ɛ	p ɛ r iː k l ɪ t aː r iː
m eː l oː r ɛ	m ɛ l j oː r ɛ m
t ɔ g a m	t ɔ g a m
f d aː r ɔ r	f ɔ r j a m
iː m s t ɪ t ʊ iː r ɛ	iː n s t ɪ t ʊ ɛ r ɛ
w ɔ r r ɛ	w ɔ r aː r ɛ
a b ɔ m ɪ n aː r ɛ	a b oː m ɪ n aː r iː
b r ʊ k ʊ m	b r uː kʰ ʊ m
s ɔ m n ɪ f ɛ r ʊ m	s ɔ m n ɪ f ɛ r ʊ m
d eː t eː r j ɪ ɔ r a t j ʊ m n ɛ m	d eː t ɛ r j oː r aː t j oː n ɛ m
a r g ɛ n t ʊ m	a r g ɛ n t ʊ m
r ɛ l ʊ k j ɪ r ɛ	r ɛ l uː k eː r ɛ
s ɛ m p ɪ t ɛ r n ʊ m	s ɛ m p ɪ t ɛ r n ʊ m
w eː n a ɔ r	w eː n aː t oː r ɛ m
p ʊ lː aː r ɛ	p ʊ lː aː r ɛ
n a s ʊ t ʊ m	n aː s uː t ʊ m
n ɔ t aː r ɛ	n ɔ t aː r ɛ
r ɔ m aː n ʊ m	r oː m aː n ʊ m
ɛ k s t ɛ n s ɪ w ʊ m	ɛ k s t eː n s iː w ʊ m
p r ɛ s k r ɪ w ɛ r ɛ m	p r aɪ s k r iː b ɛ r ɛ
ɪ g l ɛ ʊ m	a ŋ g l eː n s ɛ m
g r aː n d ɪ k ɛ m	g r a n d ɪ n ɛ m
a b ɪ g ɛ aː t ʊ m	a b ɪ g ɛ aː t ʊ m
m oː t ʊ m	m ʊ tː ʊ m
a n g ɛ l ɪ k ʊ m	a ŋ g ɛ l ɪ k ʊ m
s w ɪ ɛ k n t ɪ f ɪ k ʊ m	s k ɪ ɛ n t ɪ f ɪ k ʊ m
n ɛ r w oː s ʊ m	n ɛ r w oː s ʊ m
ɔ s aː r j ʊ m	ɔ sː aː r j ʊ m
d eː p eː r ɪ k r ɛ	d eː p ɛ r iː r ɛ
k ʊ n t ʊ r b aː r ɛ	k ɔ n t ʊ r b aː r ɛ
ɔ s t ɛ n s ɪ w ʊ m	ɔ s t eː n s iː w ʊ m
m a l ɛ d ɪ k t j oː n	m a l ɛ d ɪ k t j oː n ɛ m
r ɛ g ɛ r ɛ	r ɛ g ɛ r ɛ
r ɛ d ɪ t ʊ m	r ɛ d ɪ t ʊ m
g ʊ b a m	j ʊ b a m
p a nː ʊ m	p a nː ʊ m
ɔ m d oː r ɛ m	ɔ d oː r ɛ m
ʊ s j ɛ r ʊ m	ɔ s t j aː r j ʊ m
p eː kʷ aː r j ʊ m	p ɛ k w aː r j ʊ m
d ɛ n t a l ɛ	d ɛ n t aː l ɛ m
p eː k ʊ l ʊ m	p ɛ k uː l j ʊ m
ɪ m p eː t aː s	ɪ m p ɛ t ʊ m
a b s t r ɛ ɛ r ɛ m	a b s t r a h ɛ r ɛ
ɔ b w j aː r ɛ	ɔ b w j aː r ɛ
ɪ n k ɪ d ɪ r ɛ	ɪ ŋ k ɪ d ɛ r ɛ
b a r b a r ɪ s m ʊ m	b a r b a r ɪ s m ʊ m
b a s ʊ m	b a sː ʊ m
s eː p ʊ l k r ʊ m	s ɛ p ʊ l k r ʊ m
s a l w aː r ɛ	s a l w aː r ɛ
s ʊ n ʊ m	s ɔ n ʊ m
a s ɪ ŋ n aː r ɛ	a sː ɪ ŋ n aː r ɛ
k a p ɛ lː ʊ m	k a p ɪ lː ʊ m
ɪ b r ɪ d ʊ m	h y b r ɪ d a m
k ɔ n d eː s k ɛ n d ɛ r ɛ	k ɔ n d eː s k ɛ n d ɛ r ɛ
b ɛ aː t ʊ m	b ɛ aː t ʊ m
f r ɪ k t j oː n ɛ m	f r ɪ k t j oː n ɛ m
a m p lː ɪ f ɪ k a t j oː n	a m p l ɪ f ɪ k aː t j oː n ɛ m
p ɛ r s w a d ɛ r ɛ	p ɛ r s w aː d eː r ɛ
p a r s ɪ m oː n j a m	p a r k ɪ m oː n j a m
s ʊ k oː s ʊ m	s uː k oː s ʊ m
ɪ m p eː d ɛ r ɛ	ɪ m p ɛ d iː r ɛ
l ɪ m aː r ɛ	l iː m aː r ɛ
k ɔ n s a k r a t j ʊ m n ɛ m	k oː n s ɛ k r aː t j oː n ɛ m
f ʊ g aː k ɛ	f ʊ g aː k ɛ m
w a k ʊ ɪ t aː t ɛ m	w a k ʊ ɪ t aː t ɛ m
r aː p t ʊ m	r a p t ʊ m
aʊ s t r ʊ m	aʊ s t r ʊ m
k ɔ n s l a l d	k oː n s ɔ l ɪ d a m
s a k eː r d ɔ t ɛ m	s a k ɛ r d oː t ɛ m
k ɔ k ɔ lː ʊ m	k ʊ k ʊ lː ʊ m
m ɛ r b j aː r j ʊ m	h ɛ r b aː r j ʊ m
ɪ n w oː l w ɛ r ɛ m	ɪ n w ɔ l w ɛ r ɛ
n ɛ k t a r ɛ	n ɛ k t a r
m aː pː a m	m a pː a m
k oː n g j ʊ m	k ɔ ŋ g j ʊ m
k ɔ m p eː t ɪ t oː r ɛ	k ɔ m p ɛ t iː t oː r ɛ m
ɪ r a k ʊ n d ʊ m	iː r aː k ʊ n d ʊ m
ɛ s k ʊ l ʊ m	aɪ s k ʊ l ʊ m
f ɪ m ʊ m	f ɪ m ʊ m
r ɪ g ɪ d ʊ m	r ɪ g ɪ d ʊ m
a d m ɪ n ɪ s t r aː r ɛ	a d m ɪ n ɪ s t r aː r ɛ
d ʊ b ɪ t aː r ɛ	d ʊ b ɪ t aː r ɛ
s t ɛ r k ʊ m l	s t ɛ r k ʊ s
f ɪ m k aː r ɛ	f iː g ɛ r ɛ
ɛ w ʊ m	aɪ w ʊ m
ɔ pː oː m r ɛ	ɔ pː oː n ɛ r ɛ
p a n ɪ k l ʊ ɛ l ɛ	p aː n ɪ k ʊ l a m
p ɛ r s ɪ s t ɛ r ɛ	p ɛ r s ɪ s t ɛ r ɛ
ɪ n k a p aː k	ɪ ŋ k a p aː k ɛ m
ɔ b t ʊ s ʊ m	ɔ b t uː s ʊ m
k l uː n kʷ ʊ k	kʷ ɛ m k ʊ m kʷ ɛ
d eː s ɔ l a t j ʊ m n ɛ m	d eː s oː l aː t j oː n ɛ m
p a m p eː n ʊ m	p a m p ɪ n ʊ m
w eː n j a m	w ɛ n j a m
ɔ b l ɪ t eː r aː r ɛ	ɔ b l ɪ tː ɛ r aː r ɛ
k ɛ s p eː t ɛ m	k aɪ s p ɪ t ɛ m
n a t ɪ w ɪ t aː t ɛ m	n aː t iː w ɪ t aː t ɛ m
m a r ɪ t a l ɛ	m a r iː t aː l ɛ m
r ɛ d a r kʷ ɛ r	r ɛ d a r gʷ ɛ r ɛ
p r ɔ l ɔ ŋ g a t j ʊ m n ɛ m	p r oː l ɔ ŋ g aː t oː n ɛ m
s oː l t ʊ m	s ɔ l uː t ʊ m
p r ʊ w ɛ n t ʊ m	p r oː w ɛ n t ʊ m
p ʊ t r ɛ m	p ʊ t r ɛ m
n ɛ k s ʊ m	n ɛ k s ʊ m
l a r g ʊ m	l a r g ʊ m
b r a k aː t ʊ m	b r aː k aː t ʊ m
f l ʊ iː r ɛ	f l ʊ ɛ r ɛ
p a w ɪ l ʊ m n ɛ m	p aː p ɪ l j oː n ɛ m
f ɛ s t ʊ m	f eː s t ʊ m
s t ɔ l ɪ d ʊ m	s t ɔ l ɪ d ʊ m
k ɔ n s ɛ n t ɪ r ɛ	k oː n s ɛ n t iː r ɛ
ɪ w oː r ʊ m	ɛ b ɔ r ɛu m
k ɔ n t a m ɪ n a t j ʊ m n ɛ m	k ɔ n t aː m ɪ n aː t j oː n ɛ m
eː l ɪ m ɪ n a t j oː n ɛ m	eː l ɪ m ɪ n aː t j oː n ɛ m
ɔ r d j ʊ m	h ɔ r d ɛu m
k a m p ɛ s t r ɛ m	k a m p ɛ s t r ɛ m
ɛ k s k ɔ r j aː r ɛ	ɛ k s k ɔ r j aː r ɛ
w a k ɪ lː aː r ɛ	w a k ɪ lː aː r ɛ
ɪ w oː r l ɛ m	ɛ b ʊ r
p eː lː ɪ k a n ʊ m	p ɛ l ɛ k aː n ʊ m
m ʊ n ɪ k ɪ p a l ɛ	m uː n ɪ k ɪ p aː l ɛ m
p eː r ɪ t ʊ m	p ɛ r iː t ʊ m
aʊ d ɪ t oː r j ʊ m	aʊ d iː t oː r j ʊ m
s p ɪ n a l ɛ	s p iː n aː l ɛ m
m ʊ w iː m ɛ n t ʊ m	m oː w ɪ m ɛ n t ʊ m
w eː r t ɪ g ɛ n ɛ	w ɛ r t iː g ɪ n ɛ m
s t r iː g ɪ l ɛ	s t r ɪ g ɪ l ɛ m
s ɛ n s a t j ʊ m n ɛ m	s eː n s aː t j oː n ɛ m
ɛ k s t a s ɪ s	ɛ k s t a s ɛ m
k ɔ n s ɛ r w aː r ɛ	k oː n s ɛ r w aː r ɛ
b a n aː t ʊ m	b a l n ɛu m
a r aː b ɪ l ɛ	a r aː b ɪ l ɛ m
k ɔ l oː n ʊ m	k ɔ l oː n ʊ m
kʷ iː n t ʊ m	kʷ iː n t ʊ m
t r ɛ p ɪ d ʊ m	t r ɛ p ɪ d ʊ m
w ɔ r ʊ m	w ɔ r ʊ m
ɔ n ɔ m a t ɔ p ɛ j a m	ɔ n ɔ m a t ɔ p ɔ ɪ j a m
f ʊ l ɪ g ɪ n ɛ m	f uː l iː g ɪ n ɛ m
ɪ n k ʊ r w aː r ɛ	ɪ ŋ k ʊ r w aː r ɛ
ɔ rː m ɪ d ʊ m	h ɔ rː ɪ d ʊ m
g aː r f ʊ m	g r a pʰ j ʊ m
k ɔ r aː	kʰ ɔ r eːa m
s a l ɪ w a r ɛ	s a l iː w aː r ɛ
s ɔ l ɪ l oː g l ʊ m	s oː l ɪ l ɔ kʷ j ʊ m
a d ʊ l t ɛ r ʊ m	a d ʊ l t ɛ r ʊ m
r ʊ g ɪ n ɛ m	aɪ r uː g ɪ n ɛ m
p r ʊ w ʊ k a t ɪ w ʊ m	p r oː w ɔ k aː t iː w ʊ m
f a l a n g ɛ m	pʰ a l a ŋ g ɛ m
ɪ p n ɔ t ɪ k ʊ m	h y p n oː t ɪ k ʊ m
aː n s a m	aː n s a m
r eː m eː k eː r	r ɛ m ɪ s k eː r ɛ
f ʊ r ɪ b ʊ n d ʊ m	f ʊ r ɪ b ʊ n d ʊ m
a lː ʊ t ɪ n aː r ɛ	aː l uː k ɪ n aː r iː
k uː m p ɛ r	k oː n s p ʊ ɛ r ɛ
a d ɔ r a t j ʊ m n ɛ m	a d oː r aː t j oː n ɛ m
ɔ t j ʊ m	oː t j ʊ m
p a l oː m b aː r ʊ m	p a l ʊ m b aː r j ʊ m
k l a m oː r ɛ	k l aː m oː r ɛ m
k ɔ k t ʊ r a m	k ɔ k t uː r a m
aʊ s p ɪ k j ʊ m	aʊ s p ɪ k j ʊ m
k a r b ʊ n k ʊ l ʊ m	k a r b ʊ ŋ k ʊ l ʊ m
g ɛ m a m	g ɛ mː a m
n a d a d oː r	n a t aː t oː r ɛ m
r a s ɛ k aː r ɛ	r ɛ s ɛ k aː r ɛ
a b ɪ m ʊ m	a b y sː ʊ m
iː m p r ɔ b ɪ t aː	ɪ m p r ɔ b ɪ t aː t ɛ m
p r ɔ f ʊ n d ɪ t aː t ɛ m	p r ɔ f ʊ n d ɪ t aː t ɛ m
m k ɔ m ɛ t ɛ r ɛ	k ɔ mː ɪ tː ɛ r ɛ
f r a t ɛ r n aː l	f r aː t ɛ r n aː l ɛ m
s ʊ pː l ɪ k aː r ɛ	s ʊ pː l ɪ k aː r ɛ
a s t ʊ t j a m	a s t uː t j a m
w ɪ t r ʊ m	w ɪ t r ʊ m
d ɪ s ɪ m ɪ l ɛ	d ɪ sː ɪ m ɪ l ɛ m
t r a m s m ɪ g r aː r ɛ	t r aː n s m ɪ g r aː r ɛ
a pː ɛ n d ɛ r ɛ	a pː ɛ n d ɛ r ɛ
g a lː eː g ʊ m	g a lː aɪ k ʊ m
t r a m l ʊ k ɪ r ɛ	t r aː n s l uː k eː r ɛ
ɪ m p ɛ t r aː r ɛ	ɪ m p ɛ t r aː r ɛ
a k ɛ t aː r	oː s k ɪ t aː r ɛ
t r a n s a k t j ɔ n ɛ	t r aː n s aː k t j oː n ɛ m
s ʊ p ɛ r w a k a n ɛ ʊ m	s ʊ p ɛ r w a k aː n ɛu m
b a j aː r ɛ	b aː j ʊ l aː r ɛ
kʷ aː d r ʊ m	kʷ aː d r ʊ m
ɪ n k ɛ n s ʊ m	ɪ ŋ k eː n s ʊ m
n ɔ m ɪ n a t j oː n ɛ	n oː m ɪ n aː t j oː n ɛ m
a n ʊ m	aː n ʊ m
ɔ b s eː d ɛ r ɛ	ɔ b s ɪ d eː r ɛ
f r eː kʷ ɛ n t ɛ m	f r ɛ kʷ ɛ n t ɛ m
a l t ɛ a m	a l tʰ aɪ a m
s ɔ n j a t oː r ɛ	s ɔ m n j aː t oː r ɛ m
ɪ b ɪ l ɛ	ɪ b ɪ l ɛ m
s k iː n d ɛ r ɛ	s k ɪ n d ɛ r ɛ
d ɔ r aː r ɛ	d ɛ aʊ r aː r ɛ
s t ʊ p r ʊ m	s t ʊ p r ʊ m
a b ʊ s ɪ w ʊ m	a b uː s iː w ʊ m
pː eː n ʊ l a m	p aɪ n ʊ l a m
d ɪ l ʊ iː r ɛ	d iː l ʊ ɛ r ɛ
r ʊ t ʊ m	r uː k t ʊ m
a r b ɪ t r j ʊ m	a r b ɪ t r j ʊ m
ɛ k s t ɪ r p aː r ɛ	ɛ k sː t ɪ r p aː r ɛ
k ɔ n s k ɪ j ɛ n t j a m	k oː n s k ɪ ɛ n t j a m
t r eː p ɪ d aː r ɛ	t r ɛ p ɪ d aː r ɛ
k ɔ n f ɪ j aː r ɛ	k oː n f iː d ɛ r ɛ
p r ɛ s ɛ m t ɪ r	p r aɪ s ɛ n t iː r ɛ
b ɔ s k ɛ m m	b ɔ s k ʊ m
p r eː s ɛ p m ɛ m	p r aɪ s aɪ p ɛ
p r ɛ g ʊ d ɪ k aː r ɛ	p r aɪ j uː d ɪ k aː r ɛ
k aʊ d a l ɛ	k aʊ d aː l ɛ m
n a t aː l ɛ	n aː t aː l ɛ m
k a p t ʊ r a m	k a p t uː r a m
t a l a m ʊ m	tʰ a l a m ʊ m
s ʊ p ɛ r b l	s ʊ p ɛ r b j a m
w ɛ r t eː r ɛ	w ɛ r t ɛ r ɛ
d ɪ k aː k ɛ	d ɪ k aː k ɛ m
l a k r ɪ m oː s ʊ m	l a k r ɪ m oː s ʊ m
aː b iː t ʊ m	h a b ɪ t ʊ m
p r ɔ b ʊ m	p r ɔ b ʊ m
g l ʊ t oː n ɛ	g l ʊ tː oː n ɛ m
g r a k ɪ l ɛ	g r a k ɪ l ɛ m
f eː rː aː t ʊ m	f ɛ rː aː t ʊ m
ɪ t eː r aː r ɛ	ɪ t ɛ r aː r ɛ
p a k ɪ f ɪ k a t j oː n ɛ	p aː k ɪ f ɪ k aː t j oː n ɛ m
a k k ɛ s oː r j ʊ m	a kː ɛ sː oː r j ʊ m
t ɛ rː eː n ʊ m	t ɛ rː eː n ʊ m
k ɔ d ɪ k ɪ lː ʊ m	k oː d ɪ k ɪ lː ʊ m
d eː ŋ ɪ f iː k aː r ɛ	d ɛ ɪ f ɪ k aː r ɛ
n w ɔ t aː r ɛ	n a t aː r ɛ
k r ɪ m ɪ n oː s ʊ m	k r iː m ɪ n oː s ʊ m
s oː gː lː aʊ t ʊ m	s ɪ ŋ g ʊ l t ʊ m
s ɔ l eː r ɛ	s ɔ l eː r ɛ
kʷ aː r t ʊ m	kʷ aː r t ʊ m
ɪ b ɪ s	iː b ɛ m iː b ɪ n
aː p ɪ k k ɛ m	a p ɪ k ɛ m
t ɛ n t aː r ɛ	t ɛ m p t aː r ɛ
m eː m ɪ s t ɪ ɛ r ɛ	m ɪ n ɪ s t ɛ r j ʊ m
d ɪ m ɪ t ɪ r ɛ	d iː m ɪ tː ɛ r ɛ
lː oː m k a m	l uː t ɛu m
ɔ k k ɪ d ɛ n t ɛ m	ɔ kː ɪ d ɛ n t ɛ m
b a l t ɛ ʊ m	b a l t ɛu m
k ɔ n g ʊ r aː r ɛ	k ɔ n ɪ uː r aː r ɛ
l a l j ɛ m	aʊ r ɛ ɔ l ʊ m
s a k r a m ɛ n t a l ɛ	s a k r aː m ɛ n t aː l ɛ m
w r ɪ n k ʊ m l ʊ m	w ɪ ŋ k ʊ l ʊ m
aː k ʊ ŋ	ɛ kː ʊ m
ɪ lː ʊ s j ʊ m n ɛ m	ɪ lː uː s j oː n ɛ m
ɛ k k ɛ lː ɛ n t j a m	ɛ k s k ɛ lː ɛ n t j a m
p ɔ r t j ʊ m m	p ɔ r t j oː n ɛ m
p r eː w a l eː r ɛ	p r aɪ w a l eː r ɛ
n aʊ f r a g aː r ɛ	n aʊ f r a g aː r ɛ
b aː aː t ʊ m	b ɔ aː t ʊ m
m a n ɪ f eː s t aː r ɛ	m a n ɪ f ɛ s t aː r ɛ
ɛ k s p r ɪ m ɛ r ɛ	ɛ k s p r ɪ m ɛ r ɛ
ɔ l ɪ g aː r k ɪ k ʊ m	ɔ l ɪ g a r kʰ ɪ k ʊ m
r eː s a r k ɪ r ɛ	r ɛ s a r k iː r ɛ
t r a m s k r iː w ɛ r ɛ	t r aː n s k r iː b ɛ r ɛ
p r ɔ p r ɪ eː t aː t ɛ m	p r oː p r ɪ ɛ t aː t ɛ m
iː n f l ɛ k s j ʊ m n ɛ m	iː n f l ɛ k t j oː n ɛ m
iː m p ɔ s ɪ t j ʊ m n ɛ m	ɪ m p ɔ s ɪ t j oː n ɛ m
ɪ n ɔ w a t j oː n ɛ m	ɪ nː ɔ w aː t j oː n ɛ m
t r a b aː l ʊ m	t r ɪ p aː l ɛ m
m ɔ d ʊ l aː r ɛ	m ɔ d ʊ l aː r iː
aː d ɪ t ʊ m	a d ɪ t ʊ m
k ɔ m p ʊ n g ɛ r ɛ	k ɔ m p ʊ ŋ g ɛ r ɛ
k r ʊ m t aː r ɛ	k r ʊ s t aː r ɛ
t ɛ n s j oː n ɛ m	t eː n s j oː n ɛ m
r a s k aː r ɛ	r aː d ɛ r ɛ
f ʊ r ɛ m	f uː r ɛ m
p eː r ɪ k ʊ l oː s ʊ m	p ɛ r iː k ʊ l oː s ʊ m
k oː n k a m	k ɔ ŋ kʰ a m
n ɛ s p eː l a m	m ɛ s p ɪ l ʊ m
f ʊ n d a t oː r ɛ	f ʊ n d aː t oː r ɛ m
ɔ l w ɛ r ɛ	w ɔ l w ɛ r ɛ
aʊ r ɪ g eː r ʊ m	aʊ r ɪ g ɛ r ʊ m
l aː k t aː r j ʊ m	l a k t aː r j ʊ m
lː eː n aː r	l ɪ ŋ n aː r iː
m eː s k j ɛ r ɛ m	m ɪ s k eː r ɛ
w ɔ l ʊ p t ɛ m	w ɔ l ʊ p t aː t ɛ m
aʊ r ɪ g a m	aʊ r iː g a m
ɔ m ɛ n t ʊ m	oː m ɛ n t ʊ m
k ɔ k ʊ m	s ɔ kː ʊ m
ɪ p ɔ t ɛ k a m	h y p ɔ tʰ eː k a m
iː n g ʊ r j oː s ʊ m	ɪ n ɪ uː r j oː s ʊ m
k a r ɪ k k ɛ m	k aː r ɪ k ɛ m
ɛ k ɔ n d ɪ k ɛ r	k ɔ n d iː k ɛ r ɛ
ɔ rː ɪ f ɪ k ʊ m	h ɔ rː ɪ f ɪ k ʊ m
d eː m w j aː r ɛ	d eː w j aː r ɛ
s ʊ n aː t ʊ m	s ɔ m n j ʊ m
k ʊ r a m	k uː r a m
eː l ɔ ŋ g a t j ʊ m n ɛ m	eː l ɔ ŋ g aː t j oː n ɛ m
a r ɔ m a t ɪ k ʊ m	a r oː m a t ɪ k ʊ m
p a ɪ s ɛ	p aː g eː n s ɛ m
k ɔ n w ɪ k t j oː n ɛ m	k ɔ n w iː k t j oː n ɛ m
w eː n eː r a t j ʊ m n ɛ m	w ɛ n ɛ r aː t j oː n ɛ m
k l eː m eː n t ɪ s ɪ m ʊ m	k l eː m eː n t ɪ sː ɪ m ʊ m
l a k r ɪ m a t j ɔ n ɛ	l a k r ɪ m aː t j oː n ɛ m
a s t ʊ r ɛ	a s t ʊ r ɛ m
m a ɛ s t aː t ɛ m	m a j ɛ s t aː t ɛ m
r ɛ uː m	r h ɛu m a
s a n aː r ɛ	s aː n aː r ɛ
s p eː k ʊ l a t ɪ w ʊ m	s p ɛ k ʊ l aː t iː w ʊ m
ɪ ŋ n ɔ m ɪ n j a m	ɪ ŋ n oː m ɪ n j a m
m ɔ s k ʊ m	m ʊ s t ɛu m
w ɛ r s aː t ɪ l	w ɛ r s aː t ɪ l ɛ m
ɪ n g ɛ nː ʊ m	ɪ ŋ g ɛ n j ʊ m
f j ɛ r ʊ m	f ɛ r ʊ m
g ʊ s t ʊ m	g ʊ s t ʊ m
eː kʷ ɪ l ɪ b r j ʊ m	aɪ kʷ ɪ l iː b r j ʊ m
f ɛ r eː t r ʊ m	f ɛ r ɛ t r ʊ m
f iː d ɛ l ɪ t t ɛ m	f ɪ d eː l ɪ t aː t ɛ m
iː m f lː ɪ g ɛ r ɛ	iː n f l iː g ɛ r ɛ
a k ʊ s a t oː r ɛ	a kː uː s aː t oː r ɛ m
k a l k aː n ʊ m	k a l k aː n ɛu m
d eː n t ɪ f r ɪ k ʊ m	d ɛ n t ɪ f r ɪ k j ʊ m
n ʊ t ʊ m	n uː t ʊ m
a k ʊ m ɛ m m	a k uː m ɛ n
m a t aː s a m	m a t a k s a m
p ɪ w oː n l	p aɪ oː n j a m
a l t ɛ r k a t j ʊ m n ɛ m	a l t ɛ r k aː t j oː n ɛ m
p r eː t ɛ n d ɛ r ɛ m	p r aɪ t ɛ n d ɛ r ɛ
ɪ lː ʊ s t r ɛ m	ɪ lː uː s t r ɛ m
eː k l y s ɛ a m	ɛ kː l eː s j a m
ɪ rː ɪ g aː r ɛ	ɪ rː ɪ g aː r ɛ
p r ɔ s t ɪ t ʊ ɛ r ɛ	p r oː s t ɪ t ʊ ɛ r ɛ
k ʊ l t oː r ɛ	k ʊ l t oː r ɛ m
ɪ ŋ n ɔ r aː r ɛ	ɪ ŋ n oː r aː r ɛ
r ɪ t ʊ m	r iː t ʊ m
a k ʊ m ʊ l a t j ʊ m n ɛ m	a kː ʊ m ʊ l aː t j oː n ɛ m
f ʊ s t ɪ g aː r ɛ	f uː s t iː g aː r ɛ
ɪ m mː ɪ m p r ɛ s ɛ	ɪ mː ɪ s k eː r ɛ
k l ɪ m a t ɛ r ɪ k ʊ m	k l iː m a k t eː r ɪ k ʊ m
ɛ n t eː l ɛ g ɛ r	ɪ n t ɛ lː ɛ g ɛ r ɛ
s eː g r eː g aː r ɛ	s eː g r ɛ g aː r ɛ
w m ɛ rː k ʊ m	w ɛ rː ɛ m
s p eː l ʊ n k a m	s p eː l ʊ ŋ k a m
f a k ʊ m d ɪ n ɛ m j a m	f aː k ʊ n d j a m
g ʊ k ʊ n d ʊ m	j uː k ʊ n d ʊ m
eː k s p ʊ ŋ n aː r ɛ	ɛ k s p ʊ ŋ n aː r ɛ
iː m w ɛ s t ɪ g aː r ɛ	ɪ n w ɛ s t iː g aː r ɛ
k ɔ r ɛ	k ɔ r
a n eː l aː r ɛ	a n h eː l aː r ɛ
w ʊ l n eː r aː r ɛ	w ʊ l n ɛ r aː r ɛ
ɔ r b ʊ m	ɔ r b ʊ m
g r a m ɪ n ɛ ʊ m	g r aː m ɪ n ɛu m
a k ʊ n s eː l aː r	a kː ɔ ŋ k ɪ l j aː r ɛ
s ʊ b t ɪ l ɪ t ɛ m	s ʊ b t iː l ɪ t aː t ɛ m
a n t ɪ k ɪ p aː r ɛ	a n t ɪ k ɪ p aː r ɛ
p eː r w ɛ n ɪ r ɛ	p ɛ r w ɛ n iː r ɛ
r eː w ɔ k a t j ʊ m n ɛ m	r ɛ w ɔ k aː t j oː n ɛ m
p l aː k ɪ d ʊ m	p l a k ɪ d ʊ m
b a l b ʊ t a r ɛ	b a l b uː t iː r ɛ
r eː g m ʊ m g aː r	m ʊ sː aː r ɛ
d ʊ r aː r ɛ	d uː r aː r ɛ
r ɪ s ʊ m	r iː s ʊ m
s a p oː r ɛ m	s a p oː r ɛ m
k ɔ n k l a m r ɛ	k ɔ ŋ k l aː m aː r ɛ
m a l iː ŋ n ʊ m	m a l ɪ ŋ n ʊ m
eː k m k ɛ l s ʊ m	ɛ k s k ɛ l s ʊ m
m a t r ɪ k ɪ d j ʊ m	m aː t r ɪ k iː d j ʊ m
k ɪ d j ʊ m	k iː d j ʊ m
f a w oː r ɛ m	f a w oː r ɛ m
p eː r k ɔ rː ɛ r ɛ	p ɛ r k ʊ rː ɛ r ɛ
r ɛ s t aʊ r a t j ʊ m n ɛ m	r eː s t aʊ r aː t j oː n ɛ m
b eː n iː ŋ n ʊ m	b ɛ n ɪ ŋ n ʊ m
p r eː m ɔ n ɪ t ɔ r ɛ m	p r aɪ m ɔ n ɪ t oː r ɛ m
l a m a m	l aː m a m
l ɪ n m ɛ a m	l iː n ɛ a m
n ʊ k j ɪ r ɛ	n ɔ k eː r ɛ
n ɛ p eː t ɛ m a m	n ɛ p ɛ t a m
k r ɪ t ɛ r j ʊ m	k r ɪ t ɛ r ɪ ɔ n
k aː t a m	k a tː a m
aʊ k k j ɔ n ɛ	aʊ k t j oː n ɛ m
a b ɔ m aː s ʊ m	a b ɔ m aː s ʊ m
k r oː ŋ g r ʊ m	k ɔ ŋ g r ʊ m
a m ʊ r k l a m	a m ʊ r k a m
t ɪ m ɪ d ʊ m	t ɪ m ɪ d ʊ m
ɪ m m a t ʊ r ʊ m	ɪ mː aː t uː r ʊ m
ɛ m ɪ k r aː n j a m	h eː m ɪ k r aː n j a m
a b ɪ t w aː l ɛ	h a b ɪ t w aː l ɛ m
k a r ɛ n a m	k a r iː n a m
k ɛ n t ʊ r j a m	k ɛ n t ʊ r j a m
ɔ r d ɛ n a t ɔ r	ɔ r d ɪ n aː t oː r ɛ m
k ʊ n t ʊ m aː k ɛ	k ɔ n t ʊ m aː k ɛ m
g a w ɛ t a m	g a b a t a m
