k ɔ kː eː r iː r	k ɔ ŋ kʷ iː r ɛ r ɛ
eː d iː k t ʊ m	eː d ɪ k t ʊ m
k ɔ m p l a k ɛ r ɛ	k ɔ m p l a k eː r ɛ
ɔ m d oː r ɛ m	ɔ d oː r ɛ m
k a r n ɪ f iː k ɛ m	k a r n ɪ f ɪ k ɛ m
ɪ m p eː r iː j a m	ɪ m p ɛ r iː t j a m
r ɔ t aː r ɛ	r ɔ t aː r ɛ
p a r s iː m oː n j a m	p a r s ɪ m oː n j a m
t r iː p l eː k k ɛ	t r ɪ p l ɪ k ɛ m
b eː r iː lː ʊ m	b eː r y lː ʊ m
k ɔ r j aː k ɛ ʊ m	k ɔ r j a k ɛu m
f ʊ s t iː g aː r ɛ	f uː s t iː g aː r ɛ
iː m p r ɔ b iː t aː	ɪ m p r ɔ b ɪ t aː t ɛ m
a p r iː r ɛ	a p ɛ r iː r ɛ
r ʊ g aː r ɛ	r ɔ g aː r ɛ
t r a d ɪ r ɛ	t r aː d ɛ r ɛ
s b oː n aː a w ɛ m	s w aː w ɛ m
r ɛ f eː r iː r ɛ	r ɛ f ɛ rː ɛ
b r a k aː t ʊ m	b r aː k aː t ʊ m
r uː k j ʊ m	r oː s k ɪ d ʊ m
k ɔ r b ɛ lː ʊ m	k ɔ r b ɛ m
r a p iː r ɛ	r a p ɛ r ɛ
ɔ p uː s k ʊ l ʊ m	ɔ p ʊ s k ʊ l ʊ m
r eː f r iː g eː r a t j ʊ n ɛ m	r ɛ f r iː g ɛ r aː t j oː n ɛ m
a m eː n iː t aː t ɛ m	a m ɔ ɪ n ɪ t aː t ɛ m
aː k iː n ʊ m	a k ɪ n ʊ m
b a n j ʊ	b a l n ɛu m
k r iː m ɪ n ɛ	k r iː m ɛ n
s uː t uː r a m	s uː t uː r a m
g l aː d j ʊ m m	g l a d j ʊ m
s t a t ʊ ɛ r ɛ	s t a t ʊ ɛ r ɛ
a b s t ɛ r g eː r ɛ	a b s t ɛ r g eː r ɛ
l ɛ ɪ t ʊ m	l aɪ t ʊ m
r ɛ k l a m aː r ɛ	r ɛ k l aː m aː r ɛ
w oː t ʊ m	w oː t ʊ m
ɪ w oː r j ɛ m	ɛ b ʊ r
k ɔ n w ɔ k a t j ʊ n ɛ m	k ɔ n w ɔ k aː t j oː n ɛ m
ɔ b l iː g a t j oː n ɛ	ɔ b l ɪ g aː t j oː n ɛ m
g ɛ n ɛ s t ɛ	g ɛ n ɛ s t a m
s uː pː l iː k aː r ɛ	s ʊ pː l ɪ k aː r ɛ
r eː n ʊ iː r	r ɛ n ʊ ɛ r ɛ
iː n d a g a r ɛ	ɪ n d aː g aː r ɛ
w a lː eː t ʊ m	w a lː ɛ tː ʊ m
f a k ʊ m d ɪ n ɛ m j a	f aː k ʊ n d j a m
s a l uː b r iː t aː t ɛ m	s a l uː b r ɪ t aː t ɛ m
k r ɛ d uː l ʊ m	k r eː d ʊ l ʊ m
p ɛ m s ʊ m	p eː n s ʊ m
k r eː d iː b iː l iː t aː t ɛ m	k r eː d ɪ b ɪ l ɪ t aː t ɛ m
r eː n oː s ʊ m	a r eː n oː s ʊ m
r eː t ɪ n ɛ r ɛ	r ɛ t ɪ n eː r ɛ
a d uː l t eː r iː n ʊ m	a d ʊ l t ɛ r iː n ʊ m
f aː rː ʊ m	f a rː ɛu m
s k ɔ t j a m	s k ɔ t j a m
m a l iː ŋ n ʊ m	m a l ɪ ŋ n ʊ m
d eː p r eː d aː r ɛ	d eː p r aɪ d aː r iː
p a r y g ʊ n t aː r	p ɛ r k ɔ n t aː r iː
k ɛ p ɔ lː a m	k eː p ʊ lː a m
t ɛ k l a m	tʰ eː k a m
p ɛ l h a m	p iː l a m
lː a d r iː lː ʊ m	l a t ɛ r k ʊ l ʊ m
uː l t ɔ r ɛ	ʊ l t oː r ɛ m
m uː l t a m	m ʊ l t a m
r ɛ k eː d ɛ r ɛ	r ɛ k eː d ɛ r ɛ
k r ʊ r	k r ʊ oː r ɛ m
m ɛ l ʊ n ɛ m	m eː l oː n ɛ m
ɪ n k a r n aː r ɛ	ɪ ŋ k a r n aː r ɛ
t r iː lː ʊ m	t r iː b ʊ l ʊ m
b r aː k ɛ m	b r aː k aː s
l eː k t iː k a m	l ɛ k t iː k a m
a s ʊ lː aː r	a sː ɔ l aː r ɛ
ʊ ŋ g uː l aː t ʊ m	ʊ ŋ g ʊ l aː t ʊ m
m ɔ s k ʊ m	m ʊ s t ɛu m
b ɛ s t j iː ɔ l a m	b eː s t ɪ ɔ l a m
r ɪ m a n eː r ɛ	m a n eː r ɛ
a s ɛ aː t a m	a s eː ɪ t aː t ɛ m
k aː s aː r ʊ m	k aː s ɛ aː r j ʊ m
f l aː g r aː r ɛ	f l a g r aː r ɛ
d iː l uː iː r ɛ	d iː l ʊ ɛ r ɛ
b iː l ɛ m	b iː l ɛ m
uː r n a m	uː r n a m
a lː uː k ɛ	h a lː ʊ m
f r uː iː r ɛ	f r ʊ iː
s ʊ kː ʊ m b ɛ r ɛ	s ʊ kː ʊ m b ɛ r ɛ
f a h m oː s ʊ m	f aː m oː s ʊ m
iː n uː s iː t aː t ʊ m	ɪ n uː s ɪ t aː t ʊ m
r uː s t iː k a n ʊ m	r uː s t ɪ k aː n ʊ m
eː lː a t j oː n	eː l aː t j oː n ɛ m
p aː d eː lː a m	p a t ɛ lː a m
k iː s t ɛ r n a m	k ɪ s t ɛ r n a m
k ʊ n t ɔ r k eː r ɛ	k ɔ n t ɔ r kʷ eː r ɛ
d eː p r iː m ɛ r ɛ	d eː p r ɪ m ɛ r ɛ
ɛ f ɛ k t iː w ʊ m	ɛ fː ɛ k t iː w ʊ m
n aʊ s ɪ aː b ʊ n d ʊ m	n aʊ s ɛ aː b ʊ n d ʊ m
d eː s ɪ ŋ kː a t j ʊ n ɛ m	d eː s ɪ kː aː t j oː n ɛ m
p r eː s aː r ɛ	p r ɛ t j aː r ɛ
ɪ n t r ɔ iː t ʊ m	ɪ n t r ɔ ɪ t ʊ m
f ʊ l k a m	f ʊ l ɪ k a m
k a r b ʊ n k ʊ l ʊ m	k a r b ʊ ŋ k ʊ l ʊ m
p r ɛ s ɛ m t iː r	p r aɪ s ɛ n t iː r ɛ
f uː ŋ g ɪ r ɛ	f ʊ ŋ g iː
l iː k t oː r ɛ	l iː k t oː r ɛ m
iː d ɔ n ɛ ɛ m ʊ m	ɪ d oː n ɛ ɪ t aː t ɛ m
d eː k r ɛ t ʊ m	d eː k r eː t ʊ m
iː m p ɔ r t uː n iː t aː t ɛ m	ɪ m p ɔ r t uː n ɪ t aː t ɛ m
m a t aː s a m	m a t a k s a m
k a l w iː r	k a l w iː
a b r ɔ t a n ʊ m	a b r ɔ t ɔ n ʊ m
ɛ k s iː kː a t j ʊ n ɛ m	ɛ k sː ɪ kː aː t j oː n ɛ m
l uː t ʊ m	l uː k t ʊ m
r ɛu w ɛ r s aː r	r ɛ w ɛ r s aː r ɛ
l uː s t r ʊ m	l ʊ s t r ʊ m
k r eː m aː r ɛ	k r ɛ m aː r ɛ
ɔ d j aː r ɛ	oː d ɪ sː ɛ
f l ɔ n d a	f ʊ n d a m
d j a b oː l iː k ʊ m	d j a b ɔ l ɪ k ʊ m
b l a n d iː t j a m	b l a n d ɪ t j a m
ɪ t iː d aː t a m	a k ɪ d ɪ t aː t ɛ m
w iː w iː d ʊ m	w iː w ɪ d ʊ m
a w ɛ n iː r ɛ	a d w ɛ n iː r ɛ
s ɔ lː ɪ t uː t	s oː l ɪ t uː d ɪ n ɛ m
ɛ k s k uː r s j ʊ n ɛ m	ɛ k s k ʊ r s j oː n ɛ m
p ɛ r m ɪ t ɛ r ɛ m	p ɛ r m ɪ tː ɛ r ɛ
s a t ɛ lː iː t ɛ m	s a t ɛ lː ɪ t ɛ m
ɔ l f a t ɔ r j ʊ m	ɔ l f a k t oː r j ʊ m
w ɪ iː n a m	w iː k iː n a m
a n d aː r ɛ	a m b ʊ l aː r ɛ
n aː t ʊ m	n aː t ʊ m
eː m m k eː p ɛ r ɛ	ɛ k s k ɪ p ɛ r ɛ
s ʊ s p iː r ʊ m	s ʊ s p ɪ r j ʊ m
l a m ɛ n t ʊ m	l aː m ɛ n t ʊ m
d iː s k ʊ rː ɛ r ɛ	d ɪ s k ʊ rː ɛ r ɛ
p r oː k s iː m ʊ m	p r ɔ k s ɪ m ʊ m
ɪ n t ɛ lː ɛ kʷ ɛ t ʊ m	ɪ n t ɛ lː eː k t ʊ m
d ɛ s t iː t ʊ ɛ r ɛ	d eː s t ɪ t ʊ ɛ r ɛ
k a d aː w ɛ r ɛ	k a d aː w ɛ r
m a s k l ʊ m	m a s k ʊ l ʊ m
n uː t r iː k aː r ɛ	n uː t r iː k aː r ɛ
s iː n k ɛ r ʊ m	s ɪ ŋ k eː r ʊ m
k eː r t aː r ɛ	k ɛ r t aː r ɛ
g a rː uː l ʊ m	g a rː ʊ l ʊ m
s t aː b ɪ l ɛ	s t a b ɪ l ɛ m
n w ɔ t aː r ɛ	n a t aː r ɛ
f a s t iː g j ʊ m	f a s t iː g j ʊ m
s a l iː w a r ɛ	s a l iː w aː r ɛ
r ɛ k uː s a t j ʊ n ɛ m	r ɛ k uː s aː t j oː n ɛ m
k ɔ n s ʊ m a t j ʊ n ɛ m	k oː n s ʊ mː aː t j oː n ɛ m
eː m s aʊ r iː r ɛ	ɛ k s h aʊ r iː r ɛ
p iː ŋ gʷ ɛ m	p ɪ ŋ gʷ ɛ m
m a n iː f j ɛ s t ʊ m	m a n ɪ f ɛ s t ʊ m
w ɔ t iː f eː r aː r	w oː k ɪ f ɛ r aː r iː
eː r eː d ɪ m aː t ɛ m	h eː r eː d ɪ t aː t ɛ m
p ɛ n d ɛ r ɛ	p ɛ n d eː r ɛ
t oː r ʊ m	t aʊ r ʊ m
p r aː m t iː k ʊ m	p r a k t ɪ k ʊ m
t iː m iː d ʊ m	t ɪ m ɪ d ʊ m
t a r d ɪ m	t a r d ʊ m
d s ɛ f iː r ʊ m	z ɛ pʰ y r ʊ m
w iː t uː p eː r a b ɪ l ɛ m	w ɪ t ʊ p ɛ r a b ɪ l ɛ m
a pː ɔ n ɛ	a pː oː n ɛ r ɛ
p ʊ t r ɛ m	p ʊ t r ɛ m
f d aː r ɔ r	f ɔ r j a m
kʷ a l iː t aː t ɛ m	kʷ aː l ɪ t aː t ɛ m
w a k j ɪ ʊ m	w a k iː w ʊ m
p a r t iː t j ʊ n ɛ m	p a r t iː t j oː n ɛ m
t r uː k uː l ɛ n t ʊ m	t r ʊ k ʊ l ɛ n t ʊ m
s a k r aː r ɛ	s a k r aː r ɛ
w eː t ɛ r ɛ m	w ɛ t ɛ r ɛ m
iː ŋ n ɛ ʊ m	ɪ ŋ n ɛu m
k r eː w ɛ n t j a m	k r eː d ɛ n t j a m
t iː t uː b a m r	t ɪ t ʊ b aː r ɛ
k ɪ k ɛ ɛ m	k ɪ k ɛ r
n iː d ʊ m	n iː d ʊ m
t ɛ n ɛ m ɛ	t ɛ n ʊ ɛ m
r eː p r ɛ h ɛ n s iː b ɪ l ɛ	r ɛ p r ɛ h ɛ n s ɪ b ɪ l ɛ m
s p ɛ k ʊ j ʊ m	s p ɛ k ʊ l ʊ m
f aː s t ʊ m	f aː s t ʊ m
b aː r k a m	b a r k a m
l a k j aː r a	l a sː aː r ɛ
s p ɔ l j ʊ m	s p ɔ l j ʊ m
k ɔ n d ɛ n s a t j ʊ n ɛ m	k ɔ n d eː n s aː t j oː n ɛ m
l ʊ k t aː r ɛ	l ʊ k t aː r iː
w eː r s a m	w ɪ r ɪ d ɛ m
l uː k s	l uː k ɛ m
iː m m iː n ɛ n t ɛ m	ɪ mː ɪ n eː r ɛ
p r a n t ɛ r ɛ m	p r a n d eː r ɛ
ɪ m p iː ŋ g ɛ r ɛ m	ɪ m p ɪ ŋ g ɛ r ɛ
g r aː d ʊ m	g r a d ʊ m
ɪ t aː t ɛ m	t a t ɛ m
b ɪ s pʰ h a m	b eː s t j a m
a lː uː t iː n aː r	aː l uː k ɪ n aː r iː
n eː s ɛ aː	n ɛ s k iː r ɛ
w ɛ s t iː r ɛ	w ɛ s t iː r ɛ
iː n f ʊ n d ɛ r ɛ	iː n f ʊ n d ɛ r ɛ
a eː r ɔ m a n t j a m	aː ɛ r ɔ m a n t iː a m
k eː l eː b r aː r ɛ	k ɛ l ɛ b r aː r ɛ
a n a l ɪ	a nː aː l ɛ m
a rː ɔ g aː r ɛ	a rː ɔ g aː r ɛ
a b r iː k ʊ m	a p r iː k ʊ m
b r uː k ʊ m	b r uː kʰ ʊ m
m ɪ s k	m eː n s ɛ m
t a r d aː r ɛ	t a r d aː r ɛ
d eː p l ɔ r aː r ɛ	d eː p l oː r aː r ɛ
ɪ n f iː g ɛ r ɛ m	iː n f iː g ɛ r ɛ
g a l ɛ n a m	g a l eː n a m
p ʊ t r iː r ɛ	p ʊ t r ɛ r ɛ
s a n ɪ m oː	s aː n ʊ m
m uː n g ɛ r ɛ	m ʊ l g eː r ɛ
k ʊ k ʊ lː a m	k ʊ k ʊ lː a m
a k k ɛ p t j ʊ n ɛ m	a kː ɛ p t j oː n ɛ m
a w a l ʊ	a w ʊ l ʊ m
k a p ɛ lː ʊ m	k a p ɪ lː ʊ m
n ɛ k s ʊ m	n ɛ k s ʊ m
m ʊ r iː r ɛ	m ɔ r iː
r ɛ n ʊ n k j aː r ɛ	r ɛ n ʊ n t j aː r ɛ
b a s iː l iː k a m	b a s ɪ l ɪ k a m
s oː l ʊ m	s oː l ʊ m
t r a b ɛ k ʊ l a m	t r a b eː k ʊ l a m
k ɔ n t ɛ n t j oː n ɛ m	k ɔ n t ɛ n t j oː n ɛ m
p r ɛ s t a n t j a m	p r aɪ s t a n t j a m
p ɔ n t ɪ f iː k ɛ m	p ɔ n t ɪ f ɪ k ɛ m
g uː r iː s p r uː d ɛ n t j a	j uː r ɪ s p r uː d ɛ n t j a m
l a m b ɛ r ɛ	l a m b ɛ r ɛ
k r ʊ m t aː r ɛ	k r ʊ s t aː r ɛ
d iː s t uː r b aː r ɛ	d ɪ s t ʊ r b aː r ɛ
s a j j aː r	s a t j aː r ɛ
a pː a r iː r ɛ	a pː aː r eː r ɛ
d eː g ʊ lː aː r	d eː k ɔ lː aː r ɛ
eː m s p lː ʊ r a d ɔ r	ɛ k s p l oː r aː t oː r ɛ m
ɛ k s iː g ɛ r ɛ	ɛ k s ɪ g ɛ r ɛ
t r a n s iː r ɛ	t r aː n s iː r ɛ
eː p iː s t ʊ l ɛ m	ɛ p ɪ s t ɔ l a m
p j oː ʊ m	p j ʊ m
g r ʊ k n j iː r ɛ	g r ʊ nː iː r ɛ
uː s k j ɛ r ʊ m	ɔ s t j aː r j ʊ m
m iː l a m	m iː lː j a
s a l ɪ k ɛ t ʊ m	s a l ɪ k eː t ʊ m
a r t ɛ m iː s j a m	a r t ɛ m ɪ s j a m
d eː b iː lː iː t aː r	d eː b ɪ l ɪ t aː r ɛ
a m aː r ɪ t t ʊ k m ɛ	a m aː r ɪ t uː d ɪ n ɛ m
aː r d ʊ m	a r d ʊː m
ɔ b s ɛ r w aː r	ɔ b s ɛ r w aː r ɛ
r eː g aː r	r ɪ g aː r ɛ
f ɛ s t iː w ʊ m	f ɛ s t iː w ʊ m
t r aː w ɛ m	t r a b ɛ m
a b j eː m k j oː n	a b ɪ ɛ k t j oː n ɛ m
k eː f a l pʰ ʊ m	k ɛ pʰ a l aɪ a m
m ʊ n d aː r	m ʊ n d aː r ɛ
uː s uː r a	uː s uː r a m
l ɪ g a m ɛ n t ʊ m	l ɪ g aː m ɛ n t ʊ m
w eː n eː t m ʊ m ʊ m ɪ	w ɛ n ɛ t ʊ m
k ɔ n f iː n ɛ	k ɔ n f iː n ɛ m
n uː t aː r	n uː t aː r ɛ
s aː l m a	s a g m a m
s a r k iː n a m	s a r k ɪ n a m
s ʊ p r a kː r w eː s k ɛ r ɛ	s ʊ p ɛ r k r eː s k ɛ r ɛ
f ɔ n t a n a m	f ɔ n t aː n a m
ɛ k z ɛ m p l aː r ɛ	ɛ k s ɛ m p l aː r ɛ m
k r ɛ p r ɛ a t uː r a m	k r ɛ p aː t uː r a m
z a n k a m	z a ŋ kʰ a m
ɛ n d uː r ɛ t ɛ r	ɪ n d uː r eː s k ɛ r ɛ
p uː n a r ɛ	p ʊ ŋ n aː r ɛ
ɛ k s p iː r a t j ʊ n ɛ m	ɛ k sː p iː r aː t j oː n ɛ m
a k eː f ʊ l ɛ ʊ m	a kʷ ɪ f ɔ l j ʊ m
p ɛ r s iː s t ɛ r	p ɛ r s ɪ s t ɛ r ɛ
f uː n ɛ s t ʊ m	f uː n ɛ s t ʊ m
f iː m ʊ m	f ɪ m ʊ m
m uː r aː l a m	m uː r aː l ɛ m
eː m s t eː r j ɔ r	ɛ k s t ɛ r j oː r ɛ m
a s p ɛ kʷ ɛ t a r ɛ	a s p ɛ k t aː r ɛ
t r a m l uː k ɪ r ɛ	t r aː n s l uː k eː r ɛ
ɪ n f a n t j a m	iː n f a n t j a m
iː n f ɛ k t j oː n ɛ m	ɪ n f ɛ k t j oː n ɛ m
d eː s p eː r k ɪ r ɛ	d ɪ s p ɛ r iː r ɛ
k a l eː f a k t j ʊ m n ɛ m	k a l ɛ f a k t j oː n ɛ m
s a p eː r ɛ	s a p ɛ r ɛ
iː n s iː n aː r ɛ	iː n s ɪ n w aː r ɛ
a k eː t ʊ m	a k eː t ʊ m
k ʊ r t aː r ɛ	k ʊ r t aː r ɛ
n ɛ kʷ ɛ t a r ɛ	n ɛ k t a r
f a r t aː r ɛ	f a r k iː r ɛ
a b ɔ m iː n a t j ʊ n ɛ m	a b oː m ɪ n aː t j oː n ɛ m
k ɔ l ɔ m b a m	k ɔ l ʊ m b a m
p r ɔ m iː s j oː n ɛ m	p r ɔ m ɪ sː j oː n ɛ m
f ɛ n aɪ s t r a m	f ɛ n ɛ s t r a m
p l a n a r ɛ	p l aː n aː r j ʊ m
r eː k ɛ s iː w ʊ m	r ɛ k ɛ sː iː w ʊ m
l ʊ p a m	l ʊ p a m
w ɛ n t iː l a t j oː n ɛ	w ɛ n t ɪ l aː t j oː n ɛ m
p a p j eː r j ʊ	p a p y r ʊ m
ɛ m s iː r	ɛ k s iː r ɛ
p a k iː f iː k ʊ m	p aː k ɪ f ɪ k ʊ m
ɛ k s p l iː k a t j ʊ n ɛ m	ɛ k s p l ɪ k aː t j oː n ɛ m
a n g ɛ l iː k ʊ m	a ŋ g ɛ l ɪ k ʊ m
d uː r ʊ m	d uː r ʊ m
a d ʊ n k ʊ m	a d ʊ ŋ k ʊ m
k ɛ r w a m	k ɛ r w a m
p r ɛ s t a t j ʊ n ɛ m	p r aɪ s t aː t j oː n ɛ m
k iː n j ɛ n t ɔ s	kʷ iː ŋ g ɛ n t oː s
r a m ʊ m	r aː m ʊ m
iː n k ɛ n d j ʊ m	ɪ ŋ k ɛ n d j ʊ m
r a s eː n aː r ɛ	r ɛ s ɪ ŋ n aː r ɛ
d ɪ f ɪ aː m aː r ɛ	d ɪ fː aː m aː r ɛ
n uː b ɛ m	n uː b ɛ m
eː m m k ɛ l s ʊ m	ɛ k s k ɛ l s ʊ m
m a ŋ n aː t ɛ m	m a ŋ n aː t ɛ m
r iː g iː d ʊ m	r ɪ g ɪ d ʊ m
s ʊ m m ɛ t ɛ r ɛ m	s ʊ mː ɪ tː ɛ r ɛ
eː m a n k iː p a t j ʊ n ɛ m	eː m a ŋ k ɪ p aː t j oː n ɛ m
k ʊ r s ʊ m	k ʊ r s ʊ m
a m a t ɔ r j ʊ m	a m aː t oː r j ʊ m
f a w oː r ɛ m	f a w oː r ɛ m
a k r iː m oː n j a m	aː k r ɪ m oː n j a m
ɔ b t ɪ n eː r ɛ	ɔ b t ɪ n eː r ɛ
r uː g ʊ m ʊ m	r uː g oː s ʊ m
t ɛ d uː lː a m	s kʰ ɛ d ʊ l a m
uː r ʊ m	uː r ʊ m
k ʊ m t r ɪ w ʊ l aː r	k ɔ n t r ɪ b ʊ l aː r ɛ
s eː r aː r	s ɛ rː aː r ɛ
s uː k g eː r ɛ r ɛ	s ʊ gː ɛ r ɛ r ɛ
p eː r iː k l iː t aː r ɛ	p ɛ r iː k l ɪ t aː r iː
uː n iː k ʊ m	uː n ɪ k ʊ m
k a rː ʊ t a m	k a rː uː k a m
s iː m j ʊ m	s iː m j ʊ m
k uː r a t uː r a m	k uː r aː t uː r a m
a t w ɛ r b j ɪ a l ɛ	a d w ɛ r b j aː l ɛ m
w a k aː r ɛ	w a k aː r ɛ
k uː w iː l	k ʊ b iː l ɛ
k iː d j ʊ m	k iː d j ʊ m
n a s uː t ʊ m	n aː s uː t ʊ m
d eː s k ɪ ŋ g ɛ r ɛ	d ɪ s k ɪ ŋ g ɛ r ɛ
l a n k aː r ɛ	l a ŋ k ɛ aː r ɛ
m uː l ʊ m	m uː l ʊ m
p a l oː m b ʊ m	p a l ʊ m b ʊ m
s k iː m j a m	s iː m j a m
b j ɛ n j ʊ m	b ɪ ɛ nː j ʊ m
a d uː n t ʊ m	a d j ʊ ŋ k t ʊ m
k ɔ n t r iː s t aː r ɛ	k ɔ n t r iː s t aː r ɛ
oː r k ʊ m	ɔ r k ʊ m
k ɔ n t ɛ n t ʊ m	k ɔ n t ɛ n t ʊ m
k ɔ l ɔ r aː r ɛ	k ɔ l oː r aː r ɛ
p r eː k a k p ɛ t ʊ m	p r aɪ k ɛ p t ʊ m
s k ɔ l a s t iː k ʊ m	s kʰ ɔ l a s t ɪ k ʊ m
p ɔ m ʊ m	p oː m ʊ m
f eː r uː l a	f ɛ r ʊ l a m
p a l p iː t a t j oː n	p a l p ɪ t aː t j oː n ɛ m
b ʊ t ɛ lː ʊ	b ɔ t ɛ lː ʊ m
d iː m ɪ t ɪ r ɛ	d iː m ɪ tː ɛ r ɛ
a d ʊ ŋ t j ʊ n ɛ m	a d j ʊ ŋ k t j oː n ɛ m
g a l ɛ r ʊ m	g a l eː r ʊ m
s aː n t a r ʊ m	z ɪ n z a l a m
iː n mː uː t aː r	ɪ mː uː t aː r ɛ
h aː j ʊ n aː ɛ	j eː j uː n aː r ɛ
k ɔ n k eː d ɛ r ɛ	k ɔ ŋ k eː d ɛ r ɛ
iː m m a t uː r ʊ m	ɪ mː aː t uː r ʊ m
a lː ʊ m d ʊ l a m	a l aʊ d a m
ɛ k s p ɔ r t a t j oː n ɛ m	ɛ k s p ɔ r t aː t j oː n ɛ m
a n t eː p oː n ɛ	a n t ɛ p oː n ɛ r ɛ
r ɛ k l a m a t j oː n	r eː k l aː m aː t j oː n ɛ m
k aː s t r ʊ m	k a s t r ʊ m
ɛ t aː t ɛ m	aɪ t aː t ɛ m
k ɔ n f ɪ j aː r ɛ	k oː n f iː d ɛ r ɛ
aː s t ɪ l a m	a sː ʊ l a m
g l aʊ k ʊ m	g l aʊ k ʊ m
g aː lː ʊ m	g a lː ʊ m
s k ɔ l aː r ɛ m	s kʰ ɔ l aː r ɛ m
d eː t eː p t j ɔ d aː r aː r	d eː k ɪ p ɛ r ɛ
a r ɪ m iː lː a m	a r m ɪ lː a m
s ʊ lː aː k ɛ m ʊ	s oː l aː k j ʊ m
w ɪ s k j ʊ m	w ɪ s k ʊ m
ɪ ŋ gʷ ɪ n ɛ m	ɪ ŋ gʷ ɛ n
r eː m ʊ m	r eː m ʊ m
f ɪ y aː r ɛ	f iː d ɛ r ɛ
k ɔ n t r ɔ w ɛ r s j a m	k ɔ n t r oː w ɛ r s j a m
w a d oː s ʊ m	w a d oː s ʊ m
s ʊ b ɔ r n aː r ɛ	s ʊ b oː r n aː r ɛ
f ʊ r n aː k j a m	f ɔ r n aː k ʊ l a m
d eː b eː lː a r ɛ	d eː b ɛ lː aː r ɛ
p a l p eː b r a l	p a l p ɛ b r aː l ɛ m
f eː m ɔ r a l ɛ	f ɛ m ɔ r aː l ɛ m
l a w a t oː r j ʊ m	l a w aː t oː r j ʊ m
r ʊ ʊ m	r ʊ b ʊ m
p r ɔ r ʊ m p ɛ r ɛ m	p r oː r ʊ m p ɛ r ɛ
p r ɔ p a g a t j ʊ n ɛ m	p r oː p aː g aː t j oː n ɛ m
eː f iː k a t iː t aː	ɛ fː ɪ k aː k ɪ t aː t ɛ m
l ʊ k ɛ lː ʊ m	l ɔ k ɛ lː ʊ m
d iː f lː uː ɛ r	d ɪ fː l ʊ ɛ r ɛ
w ɛ r aː k ɛ	w eː r aː k ɛ m
k ʊ iː n aː r j ʊ m	k ɔ kʷ iː n aː r j ʊ m
k ɔ n s k ɛ ʊ m	k oː n s k j ʊ m
iː lː uː d iː r	ɪ lː uː d ɛ r ɛ
l iː t uː r g j a m	l iː t uː r g j a m
f ɛ s t ʊ m	f eː s t ʊ m
p uː p a m	p uː p a m
l uː n aː r ɛ	l uː n aː r ɛ m
s k r uː t iː n j ʊ m	s k r uː t ɪ n j ʊ m
a b ɔ m aː s ʊ m	a b ɔ m aː s ʊ m
d iː g iː t a l ɛ	d ɪ g ɪ t aː l ɛ m
iː n w eː s t iː g a t j oː n ɛ m	ɪ n w ɛ s t iː g aː t j oː n ɛ m
r eː k iː t a t j ʊ n ɛ m	r ɛ k ɪ t aː t j oː n ɛ m
s ʊ p r ɛ m pː oː n ɛ m r ɛ	s ʊ p ɛ r p oː n ɛ r ɛ
ɪ n w iː d j a m	ɪ n w ɪ d j a m
s kʷ a lː iː d ʊ m	s kʷ aː l ɪ d ʊ m
w ɛ s t r uː k ɛ m ʊ	s t r uː tʰ j oː n ɛ m
m eː r ɪ k aː r	m ɛ r k aː r iː
g l ɔ r j a r ɛ	g l oː r j aː r iː
m a s k ʊ l iː n ʊ m	m a s k ʊ l iː n ʊ m
a l t aː r ɛ	a l t a r ɛ m
l ɔ m b ʊ m	l ʊ m b ʊ m
l ʊ t oː s ʊ m	l ʊ t oː s ʊ m
p ɔ n d eː r aː r ɛ	p ɔ n d ɛ r aː r ɛ
k ɪ r k ɛ n ʊ m	k ɪ r k ɪ n ʊ m
ɔ l eː r ɛ	ɔ l eː r ɛ
iː m mː ɔ r t aː l	ɪ mː ɔ r t aː l ɛ m
s ɛ r w iː t uː t	s ɛ r w ɪ t uː d ɪ n ɛ m
f ɔ r t iː f iː k aː r ɛ	f ɔ r t ɪ f ɪ k aː r ɛ
