k a r n oː s ʊ m	k a r n oː s ʊ m
l a k s ʊ m	l a k s ʊ m
m ɔ t ɪ w ʊ m	m oː t ɪ w ʊ m
ɪ p ɔ t ɛ k a m	h y p ɔ tʰ eː k a m
k a d aː w ɛ r ʊ	k a d aː w ɛ r
oː l aː r j ʊ m	ɔ lː aː r j ʊ m
aː t ʊ m	aː t ʊ m
aʊ r ɪ g a m	aʊ r iː g a m
s eː n ʊ m	s ɪ n ʊ m
s t a b ɪ l ɛ r ɛ	s t a b ɪ l iː r ɛ
b ɛ lː ɪ k ʊ m	b ɛ lː ɪ k ʊ m
r ɛ d ɪ m g ɛ r ɛ	r ɛ d ɪ g ɛ r ɛ
b ɛ n ɛ d ɛ t ʊ m	b ɛ n ɛ d ɪ k t ʊ m
k oː sː ʊ m	k ɔ sː ʊ m
n ʊ t r ɪ r ɛ	n uː t r iː r ɛ
d eː w eː n ɪ r ɛ	d eː w ɛ n iː r ɛ
m ɔ l ɛ k ʊ l a m	m oː l ɛ k ʊ l a m
ɛ b r ɛ ʊ m	h ɛ b r aɪ ʊ m
kʷ a d r ɪ l a t ɛ r ʊ m	kʷ a d r ɪ l a t ɛ r ʊ m
m uː g ɪ t ʊ m	m uː g iː t ʊ m
r ɛ n ʊ n k j aː r ɛ	r ɛ n ʊ n t j aː r ɛ
s j ɛ r a m	s ɛ rː a m
k ɪ k aː a m	k ɪ k aː d a m
f a k j a l ɛ	f a k j aː l ɛ m
s p ɪ n a l ɛ	s p iː n aː l ɛ m
s kʷ a m a m	s kʷ aː m a m
m a k s ɪ lː aː r ɛ	m a k s ɪ lː a r ɛ m
f j ɛ r a m	f ɛ r a m
a s ɛ r ɪ r ɛ	a sː ɛ r ɛ r ɛ
m ʊ l iː n ʊ m	m ɔ l iː n ʊ m
p l uː m a m	p l uː m a m
p ɛ r s ɪ s t ɛ r ɛ	p ɛ r s ɪ s t ɛ r ɛ
s p ɛ k ɪ f ɪ k ʊ m	s p ɛ k ɪ f ɪ k ʊ m
p j oː ʊ m m	p j ʊ m
p a r a g r a f ʊ m	p a r a g r a pʰ ʊ m
w ɛ g ɛ t ʊ m	w ɛ g ɛ t ʊ m
t m w ɛ l aː r ɛ	eː w ɪ g ɪ l aː r ɛ
ɔ b t eː n ɛ r ɛ	ɔ b t ɪ n eː r ɛ
a b a t j a m	a bː aː t j a m
m k ʊ t ʊ n ɛ m	m aː l ʊ m k ɔ t oː n j ʊ m
k a r d iː n ɛ m	k a r d ɪ n ɛ m
a a l ʊ m	a w ʊ l ʊ m
n ʊ t r ɪ k aː	n uː t r iː k j ʊ m
n uː m ɛ m m	n uː m ɛ n
b ɔ m b aː r d a m	b ɔ m b a r d a m
t ɛ k s t ɪ l	t ɛ k s t ɪ l ɛ
k ɔ lː ʊ m	k ɔ lː ʊ m
iː n s a n ʊ m	iː n s aː n ʊ m
p ɔ m ʊ m	p oː m ʊ m
s ɛ r ɛ j ɪ n	s ɛ rː aː g ɪ n ɛ m
p ɔ n d ɛ r aː r ɛ	p ɔ n d ɛ r aː r ɛ
a n ʊ s	aː n ʊ m
g ʊ w ɛ r n a t ɔ r ɛ m	g ʊ b ɛ r n aː t oː r ɛ m
k a n iː n ʊ m	k a n iː n ʊ m
a p a r ɪ t j ʊ m m	a pː aː r ɪ t j oː n ɛ m
m a m ɪ lː a m	m a m ɪ lː a m
m a k l aː r ɛ	m a k ʊ l aː r ɛ
aʊ r ɪ r	h aʊ r iː r ɛ
p ɔ w oː r	p a w oː r ɛ m
s k uː rː ɪ l ɛ	s k ʊ rː iː l ɛ m
b r aː k a m	b r aː k a m
iː m p ɔ r t uː n ɪ t aː t ɛ m	ɪ m p ɔ r t uː n ɪ t aː t ɛ m
r ɛ k t a ŋ g ʊ l ʊ m	r ɛ k t a ŋ g ʊ l ʊ m
p a r ɪ r	p a r ɛ r ɛ
w ɔ l uː p t ɛ m	w ɔ l ʊ p t aː t ɛ m
s ʊ m s k r ɪ w ɛ r ɛ	s ʊ b s k r iː b ɛ r ɛ
ɛ n t ɛ m	ɛ n s
k ɔ n s ɪ l j aː r ɛ	k ɔ ŋ k ɪ l j aː r ɛ
k a p ɪ t ʊ l a t j ʊ m n ɛ m	k a p ɪ t ʊ l aː t j oː n ɛ m
aʊ s t r ʊ m	aʊ s t r ʊ m
w ɪ n k ʊ l aː r ɛ	w ɪ ŋ k ʊ l aː r ɛ
k ɪ t a r a m	k ɪ tʰ a r a m
w ɔ r t ɪ k k ɛ m	w ɔ r t ɪ k ɛ m
ɪ m aː g ɪ n ɛ m	ɪ m aː g ɪ n ɛ m
r ʊ g aː r ɛ	r ɔ g aː r ɛ
s a l uː t ɛ m	s a l uː t ɛ m
a s aː r	a sː aː r ɛ
f a j a m	f aː g ɛ a m
l a p ɪ d a t j ʊ n ɛ m	l a p ɪ d aː t j oː n ɛ m
s iː m j ʊ m	s iː m j ʊ m
s uː f r uː t ɪ k ɛ m	s ʊ fː r ʊ t ɪ k ɛ m
k ɔ m a n d aː r ɛ	k ɔ mː ɛ n d aː r ɛ
j uː g ʊ l a r ɛ	j ʊ g ʊ l aː r ɛ
a gː r ɛ d ɛ r ɛ	a gː r ɛ d iː
a n t ɛ n a m	a n t ɛ nː a m
s ʊ n ʊ	s ɔ n ʊ m
a k r ɛ t a t ɛ m	aː k r ɪ t aː t ɛ m
a k j ɛ ɛ s ɛ r ɛ	a kː w ɪ eː s k ɛ r ɛ
t ʊ r ɪ p ɔ r	t ɔ r p oː r ɛ m
n j ɛ g r ɛ t ɛ r	n ɪ g r eː s k ɛ r ɛ
p uː g ɪ l ɛ	p ʊ g ɪ l ɛ m
ɛ l ɛ w aː r ɛ	eː l ɛ w aː r ɛ
n ɔ b ɪ l oː s ʊ m	n uː b ɪ l oː s ʊ m
s p ɔ l j ʊ m	s p ɔ l j ʊ m
a l a k r ɪ t aː t ɛ m	a l a k r ɪ t aː t ɛ m
lː ɔ k uː t ɔ r	l ɔ k uː t oː r ɛ m
uː l t ɛ r j ʊ r ɛ	ʊ l t ɛ r j oː r ɛ m
d ɛ s t ɪ t ʊ ɛ r ɛ	d eː s t ɪ t ʊ ɛ r ɛ
ɛ lː a t j oː n	eː l aː t j oː n ɛ m
r ɪ n ɛ	r eː n ɛ m
d ɛ s ɪ n ɛ n m a	d eː s ɪ n ɛ n t j a m
p l aː k ɪ d ʊ m	p l a k ɪ d ʊ m
kʷ j ʊ w ɛ s ʊ m	k l aʊ d ɛ r ɛ
ɛ g r eː g ʊ m	eː g r ɛ g j ʊ m
ɔ b l ɪ g aː r ɛ	ɔ b l ɪ g aː r ɛ
p a lː uː s t r ʊ m	p a l uː s t r ɛ m
t r a n s a k t j oː n ɛ	t r aː n s aː k t j oː n ɛ m
a k j a m	a k j a m
s a l ɪ k ɛ t ʊ m	s a l ɪ k eː t ʊ m
s k aː p ʊ l a m	s k a p ʊ l a m
d ɛ k l ɪ n aː r ɛ	d eː k l iː n aː r ɛ
s ʊ s p ɪ r ʊ m	s ʊ s p ɪ r j ʊ m
r ɛ p r ɪ ɛ n d ɛ r ɛ	r ɛ p r ɛ h ɛ n d ɛ r ɛ
ɪ n w ɪ d j oː s ʊ m	ɪ n w ɪ d j oː s ʊ m
a p r ɔ b a t j ʊ m n ɛ m	a pː r ɔ b aː t j oː n ɛ m
p a r t ɪ r ɛ	p a r t iː r ɛ
k ʊ ɪ r ʊ m	k ɔ r j ʊ m
k ʊ p ʊ l aː r ɛ	k oː p ʊ l aː r ɛ
d ɔ l ɔ s ʊ m	d ɔ l oː s ʊ m
a lː ɛ g r ʊ m	a l a k r ɛ m
s a ŋ gʷ ɪ n ɔ l ɛ n t ʊ m	s a ŋ gʷ ɪ n ɔ l ɛ n t ʊ m
s k r ɪ k t uː r a m	s k r iː p t uː r a m
t r a m s g r ɛ d iː r ɛ	t r aː n s g r ɛ d iː
f a s j ɔ l a m	f a s k ɪ ɔ l a m
p r ɛ k aː r ɛ	p r ɛ k aː r iː
k ɔ n s ɛ r w a t j ʊ m n ɛ m	k oː n s ɛ r w aː t j oː n ɛ m
ɔ lː ɔ r	ɔ l oː r ɛ m
p ɛ r t uː r b a t j oː n ɛ m	p ɛ r t ʊ r b aː t j oː n ɛ m
p r ɔ s p ɛ r aː r ɛ	p r ɔ s p ɛ r aː r ɛ
kʷ aː d r ʊ m	kʷ aː d r ʊ m
s ʊ s t ɛ n t aː k ʊ l ʊ m	s ʊ s t ɛ n t aː k ʊ l ʊ m
w ɛ r ɪ f iː k aː r ɛ	w eː r ɪ f ɪ k aː r ɛ
aː m k eː b r	aː k r ɛ m
w aː lː ʊ m	w a lː ʊ m
a p a r a t ʊ m	a pː a r aː t ʊ m
d ɛ t ɛ s t a t j ʊ m n ɛ m	d eː t ɛ s t aː t j oː n ɛ m
f ɛ n aɪ s t r a m	f ɛ n ɛ s t r a m
ɪ n s ɔ n t ɛ m	iː n s ɔ n t ɛ m
p r ɛ s ɛ n t a t j ʊ n ɛ m	p r aɪ s ɛ n t aː t j oː n ɛ m
l ɔ r ɪ k a m	l oː r iː k a m
iː m p ɛ r j ɪ a l ɛ	ɪ m p ɛ r j aː l ɛ m
t ɔ g a m	t ɔ g a m
a s ɪ s t ɛ r ɛ	a sː ɪ s t ɛ r ɛ
k ɪ r k ʊ l aː r ɛ	k ɪ r k ʊ l aː r ɛ m
ɔ n oː r ɛ m	h ɔ n oː r ɛ m
a n ɛ l j ʊ m	a nː ɪ k ʊ l ʊ m
p r ɔ f ɪ t ʊ m	p r oː f ɛ k t ʊ m
g r a n aː t ʊ m	g r aː n aː t ʊ m
s ɛ p ʊ l k r ʊ m	s ɛ p ʊ l k r ʊ m
a b n oː r m ɛ m	a b n oː r m ɛ m
n ɔ t aː r ɛ	n ɔ t aː r ɛ
p a l j ʊ m	p a lː j ʊ m
m a t aː r ɛ	m a k t aː r ɛ
r ʊ r aː r	r oː r aː r ɛ
d ɔ t aː r ɛ	d oː t aː r ɛ
ɪ n k ʊ n k uː s ʊ m	ɪ ŋ k ɔ ŋ k ʊ sː ʊ m
s k ɔ p aː r ɛ	s k ɔ p ɛ r ɛ
w ɛ t uː s t ɛ m	w ɛ t ʊ s t aː t ɛ m
k r aː p uː l m a m	k r aː p ʊ l a m
f l aː g r aː r ɛ	f l a g r aː r ɛ
d ɪ f ɛ n s j oː n ɛ m	d eː f eː n s j oː n ɛ m
a m a t oː r ɛ	a m aː t oː r ɛ m
p ɛ s aː r ɛ	p eː n s aː r ɛ
w ɛ ɛ r ɛ m	w ɛ lː ɛ r ɛ
d eː f ɛ n s oː r ɛ	d eː f eː n s oː r ɛ m
d aː t a m	d a t a
ɪ n t ɛ r m ɛ t ɛ r m ɛ m	ɪ n t ɛ r m ɪ tː ɛ r ɛ
f r ɛ m ɪ r ɛ	f r ɛ m ɛ r ɛ
m ɛ l ɔ r aː r ɛ	m ɛ l j oː r aː r ɛ
a p ɛ lː aː r ɛ	a pː ɛ lː aː r ɛ
a b s ɔ r p t j oː n	a b s ɔ r p t j oː n ɛ m
m aː d r ɛ	m aː t r ɛ m
p ɛ l m a m	p iː l a m
r eː k ɔ r d aː r ɛ	r ɛ k ɔ r d aː r iː
f uː s t ɪ	f uː s t ɛ m
ɔ b iː t ʊ m	ɔ b ɪ t ʊ m
k ɪ r k uː lː aː r	k ɪ r k ʊ l aː r ɛ
k ɛ s p ɪ t ɛ m	k aɪ s p ɪ t ɛ m
w aɪ r z a m	w ɪ r ɪ d ɛ m
ɪ m m ɪ n eː n t ɛ m	ɪ mː ɪ n eː r ɛ
n aː w ɛ m	n aː w ɛ m
w ɛ n d ɪ t oː r ɛ	w eː n d ɪ t oː r ɛ m
w ɛ r g ɪ n ɛ m	w ɪ r g ɪ n ɛ m
ɛ s k r uː t aː r	s k r uː t aː r iː
r uː t ʊ m	r uː k t ʊ m
ɔ r d ɪ n aː r j ʊ m	oː r d ɪ n aː r j ʊ m
m ɔ t ʊ l ɛ m	m uː t ʊ l ʊ m
ɪ m p uː l s ʊ m	ɪ m p ʊ l s ʊ m
r ɛ k l a m aː r ɛ	r ɛ k l aː m aː r ɛ
w ɛ k sː a t j ʊ m n ɛ m	w ɛ k s aː t j oː n ɛ m
t ʊ rː m ɛ m	t ʊ rː ɛ m
a k uː m uː l a t j ʊ m n ɛ m	a kː ʊ m ʊ l aː t j oː n ɛ m
d ɛ s uː l t oː r j ʊ m	d eː s ʊ l t oː r j ʊ m
a r g ɛ n t ʊ m	a r g ɛ n t ʊ m
a b j ɛ m k j oː n	a b ɪ ɛ k t j oː n ɛ m
uː m ɪ l a t j oː n ɛ m	h ʊ m ɪ l j aː t j oː n ɛ m
s uː f ɪ k j ɛ n t j a m	s ʊ fː ɪ k ɪ ɛ n t j a m
w ɛ t ɛ r ɛ m	w ɛ t ɛ r ɛ m
g r a w ɪ t a t j oː n ɛ	g r a w ɪ t aː t j oː n ɛ m
p lː ɛ n ɪ t uː d ɛ m	p l eː n ɪ t uː d ɪ n ɛ m
p r ɔ f ɛ r iː r ɛ	p r oː f ɛ rː ɛ
w ɪ s aː r ɛ	w iː s ɛ r ɛ
l a k t aː r ɛ	l a k t aː r ɛ
d ɪ s k r ɛ t j oː n ɛ	d ɪ s k r eː t j oː n ɛ m
n w ɔ t aː r ɛ	n a t aː r ɛ
ɪ b ɪ l ɛ	ɪ b ɪ l ɛ m
b ɛ s t j aː r j ʊ m	b eː s t j aː r j ʊ m
f ʊ s a t ʊ m	f ɔ sː aː t ʊ m
w a lː a r ɛ	w a lː aː r ɛ
k a k t ɪ w ʊ m	k a p t iː w ʊ m
aː n aː lː a m	a ŋ n ɛ lː a m
m aː n t eː n ɛ r ɛ	m a n ʊ t ɛ n eː r ɛ
l aː k t aː r j ʊ m	l a k t aː r j ʊ m
k ɔ n s l ʊ d a	k oː n s ɔ l ɪ d a m
ɔ r k ɛ s t r a m	ɔ r kʰ eː s t r a m
d ɪ s eː n s ʊ m	d ɪ sː eː n s ʊ m
a n ɪ s	a n iː s ʊ m
m ɪ r t ɪ lː ʊ m	m y r t ɪ lː ʊ m
k a p t uː r a m	k a p t uː r a m
s ɪ r w w ɛ n t ɛ m	s ɛ r w ɪ ɛ n t ɛ m
k a l k ʊ l ʊ m	k a l k ʊ l ʊ m
m a n s ʊ ɛ t uː d ɪ n ɛ m	m aː n s ʊ eː t uː d ɪ n ɛ m
kʷ a l ɪ t aː t ɛ m	kʷ aː l ɪ t aː t ɛ m
p ɔ s m p oː n ɛ	p ɔ s t p oː n ɛ r ɛ
a d ɪ r ɛ	a d iː r ɛ
s w aː w ɪ t aː	s w aː w ɪ t aː t ɛ m
k ɔ m m ɔ t j oː n ɛ	k ɔ mː oː t j oː n ɛ m
d ɪ f ɛ r iː r ɛ	d ɪ fː ɛ rː ɛ
iː m p ɛ t ɪ m g ɪ k ɛ m	ɪ m p ɛ t iː g ɪ n ɛ m
p a lː oː r ɛ	p a lː oː r ɛ m
d ɪ s p a r ɪ k r ɛ	d ɪ s p a r eː r ɛ
p aː p a m	p aː p a m
l ɪ t j ɛ r	l ɛ k t w aː r j ʊ m
j j ɛ f ɪ r ʊ m	z ɛ pʰ y r ʊ m
d ɔ l aː r ɛ	d ɔ l aː r ɛ
a p r ɔ p r j a t j ʊ m n ɛ m	a pː r ɔ p r j aː t j oː n ɛ m
g ɛ n j ɪ p ɛ r ʊ m	j uː n ɪ p ɛ r ʊ m
s ʊ s p ɛ n s j oː n ɛ m	s ʊ s p eː n s j oː n ɛ m
b ɔ r s a m	b ʊ r s a m
w ɔ m l ɔ n t ɛ m m	w ɔ l ʊ n t aː t ɛ m
ɛ s k uː l eː n t ʊ m	eː s k ʊ l ɛ n t ʊ m
k ɔ n d ɪ s k ɛ n d ɛ r ɛ	k ɔ n d eː s k ɛ n d ɛ r ɛ
r ɛ g j ʊ m	r eː g j ʊ m
ɛ t ɛ r ɛ	aɪ tʰ ɛ r ɛ m
t ɛ m s uː r a m	k eː n s uː r a m
w ɪ k ɪ s ɪ t uː d ɪ n ɛ	w ɪ k ɪ sː ɪ t uː d ɪ n ɛ m
d ɔ m ɛ s t ɪ k ʊ m	d ɔ m ɛ s t ɪ k ʊ m
p a l uː d a m ɛ n t ʊ m	p a l uː d aː m ɛ n t ʊ m
ɛ b r ɪ ɛ t aː t ɛ m	eː b r ɪ ɛ t aː t ɛ m
aː k j ɛ	a k ɪ ɛ m
t r a b aː l j ʊ m	t r ɪ p aː l ɛ m
ɛ k s k ɔ r j aː r ɛ	ɛ k s k ɔ r j aː r ɛ
f ɔ m ɛ n t ʊ m	f oː m ɛ n t ʊ m
a s ɪ m ɪ l aː r ɛ	a sː ɪ m ʊ l aː r ɛ
a p ɛ n d ɛ r ɛ	a pː ɛ n d ɛ r ɛ
iː n k ʊ m b ɛ r ɛ	ɪ ŋ k ʊ m b ɛ r ɛ
k r uː d ɛ l ɛ	k r uː d eː l ɛ m
k ɔ n f ɪ s k aː r ɛ	k oː n f ɪ s k aː r ɛ
s k ʊ r s ʊ m	ɛ k s k ʊ r s ʊ m
m ʊ r a lː ɪ d aː d ɛ m	m oː r aː l ɪ t aː t ɛ m
k ɔ n s ɪ s t ɛ r ɛ	k oː n s ɪ s t ɛ r ɛ
l a n gʷ ɪ d ʊ m	l a ŋ gʷ ɪ d ʊ m
m ɔ d uː l aː r ɛ	m ɔ d ʊ l aː r iː
t r ɪ lː ʊ m	t r iː b ʊ l ʊ m
ɛ r k ɛ ɛ	eː r ɪ g ɛ r ɛ
p r ɔ k ɛ lː a m	p r ɔ k ɛ lː a m
b a s ɪ l ɪ k a m	b a s ɪ l ɪ k a m
g a w ɛ t a m	g a b a t a m
ɪ n f a n t j a m	iː n f a n t j a m
p r ɪ m ɛ r ɛ	p r ɛ m ɛ r ɛ
ɛ k s uː lː t ɛ	ɛ k s ʊ l t aː r ɛ
p aː d m r ɛ m	p a t r ɛ m
l ɪ m aː r ɛ	l iː m aː r ɛ
p r ɔ l ɛ m	p r oː l ɛ m
aː w ɛ ʊ	a w ɛ m
p r ɛ w a l eː r ɛ	p r aɪ w a l eː r ɛ
r ɛ k ʊ r ɛ r	r ɛ k ʊ rː ɛ r ɛ
aʊ d ɪ t j oː n ɛ	aʊ d iː t j oː n ɛ m
a b ɪ l ɪ t aː t ɛ m	h a b ɪ l ɪ t aː t ɛ m
s t aː t ʊ m	s t a t ʊ m
r ɛ s t aʊ r a t j ʊ m n ɛ m	r eː s t aʊ r aː t j oː n ɛ m
k uː r w aː r ɛ	k ʊ r w aː r ɛ
k ʊ m ɪ n ʊ m	k ʊ m iː n ʊ m
k ɛ p ʊ lː a m	k eː p ʊ lː a m
s k ʊ m	ɪ s k ʊ m
s m ʊ w eː r ɛ	eː m ɔ w eː r ɛ
a r m aː t ʊ m	a r m aː t ʊ m
l uː p iː n ʊ m	l ʊ p iː n ʊ m
p h ɛ k t ɪ n aː r ɛ	p ɛ k t ɪ n aː r ɛ
w ɛ d ɪ n ɛ m ʊ m	w ɔ k ɪ t ʊ m
n ʊ m ɛ r ɔ s ʊ m	n ʊ m ɛ r oː s ʊ m
n uː b ɛ m	n uː b ɛ m
ɪ n aʊ d ɪ t ʊ m	ɪ n aʊ d iː t ʊ m
k ɔ m p aː t r ɛ m	k ɔ m p a t r ɛ m
s t uː d j aː r ɛ	s t ʊ d eː r ɛ
w a n ɪ	w a nː ʊ m
p ɔ n t ɪ f iː k ɛ m	p ɔ n t ɪ f ɪ k ɛ m
ɔ d j ʊ m	ɔ d j ʊ m
p ɛ s t r iː n ʊ m	p ɪ s t r iː n ʊ m
f a l d ɪ s t ɔ r j ʊ m	f a l d ɪ s t oː l j ʊ m
w ɛ n d ɛ m j aː r ɛ	w iː n d eː m j aː r ɛ
iː ŋ g uː r j a m	ɪ n ɪ uː r j a m
rː ɛ b ɛ lː aː r	r ɛ b ɛ lː aː r ɛ
m ɪ l ɪ t ɛ m	m iː l ɪ t ɛ m
r a k ɪ m ɔ s ʊ m	r a k eː m oː s ʊ m
m oː r ɛ m	m oː r ɛ m
a b r ɛ w j a t j ʊ m n ɛ m	a bː r ɛ w j aː t j oː n ɛ m
l ɛ n t ʊ m	l ɛ n t ʊ m
d ɛ l a t oː r ɛ	d eː l aː t oː r ɛ m
s a k ɛ r d ɔ t j ʊ m	s a k ɛ r d oː t j ʊ m
s ʊ l aː r ɪ j ʊ m	s oː l aː r j ʊ m
g uː s t ʊ m	j uː s t ʊ m
k r aː t iː k ʊ l a m	k r aː t ɪ k ʊ l a m
k ɛ d r ʊ m	k ɛ d r ʊ m
k a lː ɛ m	k a lː ɛ m
b ɛ s t iː ɔ l a m	b eː s t ɪ ɔ l a m
k ʊ p l a m	k oː p ʊ l a m
a k uː s aː b eː l ɛ	a kː uː s aː b ɪ l ɛ m
t ɛ n ʊ ɛ	t ɛ n ʊ ɛ m
m ɛ s uː r a m	m eː n s uː r a m
a r ɪ m ɪ lː a m	a r m ɪ lː a m
w aː t ɛ m	w aː t ɛ m
rː aː p t ʊ m	r a p t ʊ m
r a n ɔ kː l oː l	r aː n ʊ ŋ k ʊ l ʊ m
a l w ɛ r ʊ m	a l b aː r j ʊ m
ɛ m m k ɛ p t aː r ɛ	ɛ k s k ɪ p ɛ r ɛ
a b l ʊ m	ɛ b ʊ l ʊ m
kʷ ɪ t a n m a	kʷ ɪ eː t a n t j a m
a r ɪ ɛ t ɛ m	a r ɪ ɛ t ɛ m
m ʊ d ɛ r	m ɔ l ɛ r ɛ
r ɛ m ʊ w eː r ɛ	r ɛ m ɔ w eː r ɛ
ɪ m mː ɔ l aː r ɛ	ɪ mː ɔ l aː r ɛ
ɪ s t r j oː n ɛ m	h ɪ s t r j oː n ɛ m
iː m p aː w ɪ d ʊ m	ɪ m p a w ɪ d ʊ m
k iː g ʊ ɔ n a m	k ɪ k oː n j a m
iː n k uː d ɛ m ɛ	ɪ ŋ k uː d ɛ m
ʊ r ɪ n a m	uː r iː n a m
n ɛ g ɔ t j a t j ʊ m n ɛ m	n ɛ g oː t j aː t j oː n ɛ m
k ɔ m p a s ɪ b lː ɛ	k ɔ m p a sː ɪ b ɪ l ɛ m
w ɛ n j a m	w ɛ n j a m
p a t ɛ r ɪ n ʊ m	p a t ɛ r n ʊ m
aː s ɪ l a m	a sː ʊ l a m
p ɛ t iː r ɛ	p ɛ t ɛ r ɛ
m a t uː t iː n ʊ m	m aː t uː t iː n ʊ m
k ɛ l ɛ b r ɛ m	k ɛ l ɛ b r ɛ m
k ɔ n w ɛ k s ʊ m	k ɔ n w ɛ k s ʊ m
s ʊ m m ɛ t ɛ r ɛ m	s ʊ mː ɪ tː ɛ r ɛ
a b ɔ m ɪ n a t j ʊ m n ɛ m	a b oː m ɪ n aː t j oː n ɛ m
s aː ŋ kʷ ɪ r aː r ɛ	s a ŋ gʷ ɪ n aː r ɛ
ɪ d ɛ n t ɪ k ʊ m	iː d ɛ n t ɪ k ʊ m
a g r ɛ s t ɛ m	a g r ɛ s t ɛ m
a k uː s aː r ɛ	a kː uː s aː r ɛ
a m b ɔ s	a m b oː s
p r ɛ uː m b ʊ l ʊ m	p r aɪ a m b ʊ l ʊ m
l ɛ g uː l ɛ j ʊ m	l eː g ʊ l eː j ʊ m
k a n oː n ɛ	k a n ɔ n ɛ m
p r ɪ m w aɪ r a n ɛ m	w eː r
g uː s t a t j ʊ m n ɛ m	g ʊ s t aː t j oː n ɛ m
s ɛ k uː r ɛ m	s ɛ k uː r ɛ m
d ɛ k ɔ r aː r ɛ	d ɛ k ɔ r aː r ɛ
l a r j ɛ m	aʊ r ɛ ɔ l ʊ m
k ɔ m uː n a l	k ɔ mː uː n aː l ɛ m
s ɔ m ɪ aː r ʊ m	s a g m aː r j ʊ m
iː n s ɪ ŋ n ɛ m	iː n s ɪ ŋ n ɛ m
g ɛ m a m	g ɛ mː a m
k ʊ n t uː m ɛ l j a m	k ɔ n t ʊ m eː l j a m
k ɔ kʷ ɛ	k ɔ kː ʊ m
g r a w aː r ɛ	g r a w aː r ɛ
f l uː iː r ɛ	f l ʊ ɛ r ɛ
ɪ n d ɛ f ɪ n ɪ t ʊ m	ɪ n d eː f iː n iː t ʊ m
l a r w a m	l aː r w a m
l oː k aː r ɛ	l ɔ k aː r ɛ
a m b ɪ kʷ ɪ t aː t ɛ m	a m b ɪ gʷ ɪ t aː t ɛ m
t r ɔ n ʊ m	tʰ r ɔ n ʊ m
k ɔ m ɪ s j oː n ɛ m	k ɔ mː ɪ sː j oː n ɛ m
k ɔ n f iː n ɛ	k ɔ n f iː n ɛ m
s ɔ n aː r ɛ	s ɔ m n j aː r ɛ
ɪ m p r ɛ k aː r ɛ	ɪ m p r ɛ k aː r iː
p ɛ k a t oː r ɛ	p ɛ kː aː t oː r ɛ m
n uː m ɛ r ɔ s ɪ t aː t ɛ m	n ʊ m ɛ r oː s ɪ t aː t ɛ m
d ɔ r m ɪ t aː r	d ɔ r m iː t aː r ɛ
m a ŋ g aː r ɛ	m a n d uː k aː r ɛ
ɪ n ɔ w a t j oː n ɛ m	ɪ nː ɔ w aː t j oː n ɛ m
ɪ t ɛ r aː r ɛ	ɪ t ɛ r aː r ɛ
r a p iː r ɛ	r a p ɛ r ɛ
m ʊ d ʊ m	m ɔ d j ʊ m
a m ɛ n t ɛ m	aː m ɛ n t ɛ m
r ɛ k j aː n t ɛ m	r ɛ k ɛ n t ɛ m
w ɪ t uː p ɛ r a t j oː n ɛ	w ɪ t ʊ p ɛ r aː t j oː n ɛ m
l a n oː s ʊ m	l aː n oː s ʊ m
ɪ m p ɛ t r aː r ɛ	ɪ m p ɛ t r aː r ɛ
f a b ʊ l oː s ʊ m	f aː b ʊ l oː s ʊ m
ɛ d ɪ f ɪ k a k j oː n	aɪ d ɪ f ɪ k aː t j oː n ɛ m
iː m s t r uː m ɛ m t a l	iː n s t r uː m ɛ n t aː l ɛ m
w ɛ r ɪ f ɪ k a t j oː n ɛ	w ɛ r ɪ f ɪ k aː t j oː n ɛ m
s t r aː d a m	s t r aː t a m
iː m t ɛ r g ɛ k t j ʊ m m	ɪ n t ɛ r j ɛ k t j oː n ɛ m
n a w ɪ k ɛ lː a	n aː w ɪ k ɛ lː a m
a m a l g a m a m	a m a l g a m a
iː n f l a t j ʊ m n ɛ m	iː n f l aː t j oː n ɛ m
k a r ɛ n a m	k a r iː n a m
a k r ɪ t uː d ɛ m	aː k r ɪ t uː d ɪ n ɛ m
w ɛ r ɪ t aː t ɛ m	w eː r ɪ t aː t ɛ m
f ʊ n d a t oː r ɛ	f ʊ n d aː t oː r ɛ m
k ɪ r k eː n ʊ m	k ɪ r k ɪ n ʊ m
aː k t ʊ m	aː k t ʊ m
l ɛ n t ɛ r n a m	l a n t ɛ r n a m
b ʊ m b ʊ m	b ɔ m b ʊ m
s uː p m ɛ r m ʊ m	s uː b ɛ r ɛ m
ɛ r a m	aɪ r a m
fː uː m ɪ k r ɛ	f uː m ɪ g aː r ɛ
g ɛ m ɛu m ʊ m	g ɛ m ɛ lː ʊ m
ɪ rː ʊ m p ɛ r ɛ	ɪ rː ʊ m p ɛ r ɛ
k a l aː r ɛ	kʰ a l aː r ɛ
w a l ɛ t uː d ɪ n aː r j ʊ m	w a l eː t uː d ɪ n aː r j ʊ m
