p a r t ɪ t j oː n ɛ m	p a r t iː t j oː n ɛ m
p a d eː lː a m	p a t ɛ lː a m
p ɔ m ɪ f ɛ r ʊ m	p oː m ɪ f ɛ r ʊ m
a d ɪ r	a dː ɛ r ɛ
w ɛ r g a m	w ɪ r g a m
w ɛ lː ʊ m	w ɛ lː ʊ s
ɛ s t r ɛ n a m	s t r eː n a m
ɪ n k ɔ m p ɛ t ɛ n t ɛ m	ɪ ŋ k ɔ m p ɛ t ɛ n t ɛ m
l a m ɛ n t aː r ɛ	l aː m ɛ n t aː r ɛ
k ɔ m p ɛ t ɛ r ɛ	k ɔ m p ɛ t ɛ r ɛ
k ɔ l ʊ b r ɪ n ʊ m	k ɔ l ʊ b r iː n ʊ m
s k ɔ l aː s t ɪ k ʊ m	s kʰ ɔ l a s t ɪ k ʊ m
a d ɪ t ʊ m	a d ɪ t ʊ m
k a w ɪ lː aː r ɛ	k a w ɪ lː aː r iː
f a k ɪ l ɪ t aː t ɛ m	f a k ɪ l ɪ t aː t ɛ m
m ɛ s ɛ r ɛ	m ɪ s k eː r ɛ
d ɛ n ʊ n k t j ʊ m t j ɛ m n	d eː n ʊ n t j aː t j oː n ɛ m
l ɪ m ʊ m	l iː m ʊ m
m a k aː r ɛ	m a k ʊ l aː r ɛ
d ɛ n ʊ d aː r ɛ	d eː n uː d aː r ɛ
w a rː ɛ r ɛ	w ɛ rː ɛ r ɛ
l ʊ p a m	l ʊ p a m
t r ɪ lː ʊ m	t r iː b ʊ l ʊ m
k a s t r aː t ʊ m	k a s t r aː t ʊ m
r ɛ b ɛ l aː r ɛ	r ɛ b ɛ lː aː r ɛ
s ʊ s p ɪ r aː r ɛ	s ʊ s p iː r aː r ɛ
ɛ b d ɔ m aː d a m r j ʊ m	h ɛ b d ɔ m a d aː r j ʊ m
d ɛ f ɛ n s a m	d eː f ɛ n s a m
a nː ɔ t aː t j oː n ɛ m	a nː ɔ t aː t j oː n ɛ m
s ɔ l aː r ɪ j ʊ m	s oː l aː r j ʊ m
s ɔ l ɪ d aː r ɛ	s ɔ l ɪ d aː r ɛ
k a t aː r aː k t a m	k a t a r a k t a m
p a r ɪ r ɛ	p a r ɛ r ɛ
f ɔ sː aː t ʊ m	f ɔ sː aː t ʊ m
d ɪ s p a m r aː r ɛ	d ɪ s p a r aː r ɛ
r ɛ k ɛ sː ʊ m	r ɛ k ɛ sː ʊ m
p ɛ r s ɛ kʷ ɪ r ɛ	p ɛ r s ɛ kʷ iː
g ɛ m ɪ t ʊ m	g ɛ m ɪ t ʊ m
r ɔ s t r ʊ m	r oː s t r ʊ m
a g r ɪ m ɛ n s oː r ɛ m	a g r iː m eː n s oː r ɛ m
t a r d aː r ɛ	t a r d aː r ɛ
d ɪ w ɛ r t ɪ r ɛ	d iː w ɛ r t ɛ r ɛ
w ɛ r ɪ f ɪ k aː r ɛ	w eː r ɪ f ɪ k aː r ɛ
l a sː ʊ m	l a sː ʊ m
r ɛ g ʊ l aː r ɛ	r eː g ʊ l aː r ɛ m
r ɪ g ɪ d ʊ m	r ɪ g ɪ d ʊ m
m ɪ l j aː r ʊ m	m iː lː j aː r j ʊ m
k ɔ ŋ g r ɛ g aː r ɛ	k ɔ ŋ g r ɛ g aː r ɛ
t a pː ɛ t ʊ m	t a p eː t ɛ m
ɔ l ɪ r ɛ	ɔ l eː r ɛ
p r ɛ ɔ kː uː p aː r ɛ	p r aɪ ɔ kː ʊ p aː r ɛ
a ɛ r ɔ m a n t j a m	aː ɛ r ɔ m a n t iː a m
j uː s t ʊ m	j uː s t ʊ m
ɪ n mː aː t ʊ r ʊ m	ɪ mː aː t uː r ʊ m
a k ʊ m ɪ n aː r ɛ	a k uː m ɪ n aː r ɛ
a r b ɛ t ʊ m	a r b ʊ t ʊ m
ɛ g r ɛ g ɪ ʊ m	eː g r ɛ g j ʊ m
a kː ɔ rː ɛ r ɛ	a kː ʊ rː ɛ r ɛ
w ɛ k ɪ	w ɪ k ɛ m
l ɪ g aː m ɛ n t ʊ m	l ɪ g aː m ɛ n t ʊ m
k a n ɛ s t r ʊ m	k a n ɪ s t r ʊ m
d ɪ s t r ʊ t j oː n ɛ m	d eː s t r ʊ k t j oː n ɛ m
p ɔ s t ɛ r ʊ m	p ɔ s t ɛ r ʊ m
s a k ɛ r d oː t ɛ m	s a k ɛ r d oː t ɛ m
ɛ k s ɪ gʷ ʊ m	ɛ k s ɪ gʷ ʊ m
d ɔ t aː t j ʊ m n ɛ m	d oː t aː t j oː n ɛ m
ɛ s t ɪ w ʊ m m	aɪ s t iː w ʊ m
t ɛ n s j oː n ɛ	t eː n s j oː n ɛ m
s p ɔ l j ʊ m	s p ɔ l j ʊ m
t uː r p ɪ t uː d ɪ n ɛ m	t ʊ r p ɪ t uː d ɪ n ɛ m
k ɔ n ɛ k sː j oː n ɛ m	k ɔ nː ɛ k s j oː n ɛ m
k ɔ n f ʊ t a m r ɛ	k oː n f uː t aː r ɛ
d ɛ t ɛ r g ɛ r ɛ	d eː t ɛ r g eː r ɛ
s a l ʊ t aː r ɛ	s a l uː t aː r ɛ m
p ɛ r k ɔ l aː r ɛ	p ɛ r k oː l aː r ɛ
b a s ʊ m	b a sː ʊ m
t r aː b aː l	t r a b aː l ɛ m
ɛ n d ʊ r ɛ m t ɛ r	ɪ n d uː r eː s k ɛ r ɛ
g r aː n d ɪ n ʊ m	g r a n d ɪ n ɛ m
s ɪ k aː r j ʊ m	s iː k aː r j ʊ m
k a l ɛ f aː k t j oː n ɛ m ɛ m	k a l ɛ f a k t j oː n ɛ m
t r a n s g r ɛ t ɪ r ɛ	t r aː n s g r ɛ d iː
s ɔ l ɪ t uː m r ɛ	s oː l ɪ t uː d ɪ n ɛ m
a w ɛ l ʊ n aː	a b ɛ lː a n a m
k r ɪ t ɪ k ʊ m	k r ɪ t ɪ k ʊ m
b a l aː r ɛ	b aː l aː r ɛ
t r aː l a m	t r aː g ʊ l a m
m ɛ d ɪ k aː m ɛ n t ʊ m	m ɛ d ɪ k aː m ɛ n t ʊ m
p ɛ r k ɔ l aː t j ʊ m n ɛ m	p ɛ r k oː l aː t j oː n ɛ m
p a r t ɪ r ɛ	p a r t iː r ɛ
ɔ n oː r ɛ	h ɔ n oː r ɛ m
ɛ k l ɛ s a m	ɛ kː l eː s j a m
ɪ n s ɪ n w aː r ɛ	iː n s ɪ n w aː r ɛ
ɔ b s ɛ r w aː r ɛ	ɔ b s ɛ r w aː r ɛ
m ɛ d j ʊ m	m ɛ d j ʊ m
k l aː r ɪ t aː t ɛ m	k l aː r ɪ t aː t ɛ m
ɪ n w ɛ n ɛ m ɪ n aː r ɛ	w ɛ n eː n aː r ɛ
ɔ b t ɛ m p ɛ r aː r ɛ	ɔ b t ɛ m p ɛ r aː r ɛ
ɪ p ɛ r t ɛ p t ɪ b l ɛ m ɛ m	ɪ m p ɛ r k ɛ p t ɪ b ɪ l ɛ m
w ɪ m ɛ n t ɛ m	w ɛ h ɛ m ɛ n t ɛ m
s ɛ k ʊ r ɛ m	s ɛ k uː r ɛ m
b ʊ b ɔ n ɪ k ʊ m	b uː b oː n ɪ k ʊ m
ɪ n w ɛ s t ɪ r ɛ	ɪ n w ɛ s t iː r ɛ
ɪ n d aː m n ɛ m	ɪ n d ɛ m n ɛ m
k ɛ ɛ t ʊ d ɛ m	kʷ ɪ eː t uː d ɪ n ɛ m
p a s t ɪ m n aː k a m	p a s t ɪ n aː k a m
ɛ k s p l a m n aː r ɛ	ɛ k s p l aː n aː r ɛ
ɔ b ɛ d j ɛ n t j a m	ɔ b ɔ ɪ d ɪ ɛ n t j a m
s ɔ r ɪ k ɛ	s oː r ɪ k ɛ m
gʷ a s t aː r ɛ	w a s t aː r ɛ
ɔ r ɪ g ɪ n aː r j ʊ m	ɔ r iː g ɪ n aː r j ʊ m
p ɛ r s ɪ k a m	p ɛ r s ɪ k a m
a m ɛ n t ɛ	aː m ɛ n t ɛ m
ɛ m aː k ɪ t aː	ɛ m aː k ɪ t aː t ɛ m
n aʊ f r aː g ʊ m	n aʊ f r a g ʊ m
k r ʊ s t r ɛ a m	k r ʊ s t a m
f a b r ɪ k aː r ɛ	f a b r ɪ k aː r ɛ
k ʊ l uː m ɛ lː a m	k ɔ l ʊ m ɛ lː a m
t ɪ m oː n ɛ m	t eː m oː n ɛ m
n ɛ f aː n d ʊ m	n ɛ f a n d ʊ m
s ʊ p ɛ r w a m k aː n ɛ ʊ m	s ʊ p ɛ r w a k ʊː m
s p ɛ k ɪ f ɪ k ʊ m	s p ɛ k ɪ f ɪ k ʊ m
a n ɔ m a m l ʊ m	a n oː m a l ɔ n
k ɔ n s ʊ p t j oː n ɛ m	k oː n s uː m p t j oː n ɛ m
k ɔ n f j aː r ɛ	k oː n f iː d ɛ r ɛ
f ɛ k ʊ l ɛ n t ʊ m	f aɪ k ʊ l ɛ n t ʊ m
k ɔ ɪ t ʊ m	k ɔ ɪ t ʊ m
a pː r ɔ k aː r ɛ	a pː r ɔ p j aː r ɛ
r a p ɪ r ɛ	r a p ɛ r ɛ
f ʊ n t ɛ m	f ɔ n t ɛ m
ɪ sː ɪ m ʊ m	ɪ sː ɪ m ʊ m
a m ɪ g d aː l aː	a m y g d a l ʊ m
w ɪ t ʊ p ɛ r aː t j ʊ m n ɛ m	w ɪ t ʊ p ɛ r aː t j oː n ɛ m
a ɛ r ɪ ʊ m	aː ɛ r j ʊ m
a l ɔ s a m	a l aʊ s a m
ɪ d ɛ n t ɪ t aː t ɛ m	iː d ɛ n t ɪ t aː t ɛ m
n ʊ t r ɪ t aː	n uː t r iː k j ʊ m
w ɔ r aː g ɪ n ɛ	w ɔ r aː g ɪ n ɛ m
a kː aː d ɛ m j a m	a k a d eː m iː a m
s ɔ l ɛ r ɛ	s ɔ l eː r ɛ
w ɛ l ɔ k ɛ	w eː l oː k ɛ m
k ɛ r j ʊ m	k eː r ɛu m
ɪ ŋ g ɛ n j ʊ m s ʊ m	ɪ ŋ g ɛ n j oː s ʊ m
a k aː p ɛ m	a g a p eː n
p ɔ n d ɛ r aː t j ʊ m n ɛ m	p ɔ n d ɛ r aː t j oː n ɛ m
s t r ɪ ŋ g ɛ r ɛ	s t r ɪ ŋ g ɛ r ɛ
l uː n aː r ɛ	l uː n aː r ɛ m
a m ɔ w ɪ b ɪ l ɛ	aː m ɔ w eː r ɛ
k r uː ɛ n t aː r ɛ	k r ʊ ɛ n t aː r ɛ
f a s t ɪ g j ʊ m	f a s t iː g j ʊ m
k ɛ l ɛ b r ɛ m	k ɛ l ɛ b r ɛ m
a k t oː r ɛ	aː k t oː r ɛ m
g ɔ d ɛ r ɛ	g aʊ d eː r ɛ
s p ɛ r aː r ɛ	s p eː r aː r ɛ
t ɔ r p oː r ɛ	t ɔ r p oː r ɛ m
m ɛ m b r aː n aː k ɛ ʊ m	m ɛ m b r aː n aː k ɛu m
m a g ɪ k ʊ m	m a g ɪ k ʊ m
s a l aː k ɛ	s a l aː k ɛ m
l a r w aː	l aː r w a m
m a l ɛ d ɪ k ɛ r ɛ	m a l ɛ d iː k ɛ r ɛ
d ɛ s ɪ d j a m	d eː s ɪ d j a m
p r ɔ p r j ʊ m	p r oː p r j ʊ m
k a k t ɪ w ʊ m	k a p t iː w ʊ m
k ʊ w ɪ l	k ʊ b iː l ɛ
r ɛ t r ɔ k ɛ d ɛ r ɛ m	r ɛ t r oː k eː d ɛ r ɛ
j uː s t ɪ f ɪ k aː t j oː n ɛ m	j uː s t ɪ f ɪ k aː t j oː n ɛ m
m ʊ l k ɛ r ɛ	m ʊ l k eː r ɛ
d ɛ l ɪ t ʊ m	d eː l ɪ k t ʊ m
s ɔ l ɪ l ɔ kʷ j ʊ m	s oː l ɪ l ɔ kʷ j ʊ m
p r ɛ p ɔ s t ɛ r ʊ m	p r aɪ p ɔ s t ɛ r ʊ m
t r aː t aː t ʊ m	t r a k t aː t ʊ m
s ʊ mː ɪ t aː t ɛ m	s ʊ mː ɪ t aː t ɛ m
a k s ɪ l j ʊ m	aʊ k s ɪ l j ʊ m
ɪ n k l ɔ ɪ r	ɪ ŋ k l uː d ɛ r ɛ
s oː r ɛ lː a m	s ɔ r oː r ɛ m
ɛ s ɪ t aː r ɛ	h aɪ s ɪ t aː r ɛ
f a s t ɪ d j oː s ʊ m	f a s t iː d j oː s ʊ m
g aʊ d ʊ m	g aʊ d j ʊ m
t ɛ t r ɪ k ʊ m	t aɪ t r ɪ k ʊ m
d ɛ l ɪ t j a m	d eː l ɪ k j aː s
d ɪ s k r ɛ m p aː n t j a m	d ɪ s k r ɛ p a n t j a m
uː m ɪ d ʊ m	h uː m ɪ d ʊ m
t aː ŋ g ɛ r ɛ	t a ŋ g ɛ r ɛ
a w ʊ	a w ʊ m
ɛ l uː d ɛ r ɛ	eː l uː d ɛ r ɛ
r a g ɪ r	r ɛ a g eː r ɛ
a b aː k ʊ l ʊ m	a b a k ʊ l ʊ m
t ʊ b ɛ r ʊ m s ʊ m	t uː b ɛ r oː s ʊ m
f l ɔ r ɪ l ɛ g ʊ m	f l oː r ɪ l ɛ g j ʊ m
f r aː s ɪ n ʊ m	f r a k s ɪ n ʊ m
ɪ lː uː s t r ɛ	ɪ lː uː s t r ɛ m
r a z ɔ n a b ɪ l ɛ	r a t j oː n aː b ɪ l ɛ m
ɪ n s ɪ ŋ n ɛ m	iː n s ɪ ŋ n ɛ m
p r ɛ t ɛ k s t aː r ɛ	p r aɪ t ɛ k s ɛ r ɛ
d ɛ b ɛ lː aː r ɛ	d eː b ɛ lː aː r ɛ
d a n oː s ʊ m	d a m n oː s ʊ m
ɔ pː oː n r ɛ	ɔ pː oː n ɛ r ɛ
k a m b j ʊ m m	k a m b j ʊ m
l ɛ n ɛ	l eː n ɛ m
r ɛ k ʊ s aː t j oː n ɛ m	r ɛ k uː s aː t j oː n ɛ m
a k s ɛ m	uː ŋ k t j oː n ɛ m
r ɛ t ɪ n aː k l ʊ m	r ɛ t ɪ n aː k ʊ l ʊ m
w ʊ l g ʊ m	w ʊ l g ʊ s
m a n t ɪ p m j ʊ m	m a ŋ k ɪ p j ʊ m
k ɔ t ɔ r n ɪ k ɛ	k oː t ʊ r n iː k ɛ m
w ɔ l w ɛ r ɛ	w ɔ l w ɛ r ɛ
p ɔ m ʊ m	p oː m ʊ m
ɪ ŋ g ɛ n ɛ d r aː r ɛ	ɪ ŋ g ɛ n ɛ r aː r ɛ
s ʊ s t ɛ n t aː r ɛ	s ʊ s t ɛ n t aː r ɛ
s a t ɛ lː ɪ t ɛ	s a t ɛ lː ɪ t ɛ m
ɛ m uː l ʊ m	aɪ m ʊ l ʊ m
a nː ɔ n a m	a nː oː n a m
k a l k ɔ l a m t j oː n ɛ m	k a l k ʊ l aː t j oː n ɛ m
r ɛ m ɛ m b r aː r ɛ	r ɛ m ɛ m ɔ r aː r iː
k ʊ l ɛ	k aʊ l ɛ m
k a l k aː r ɛ ʊ m	k a l k aː r j ʊ m
p a l m ʊ m	p a l m ʊ m
s a n aː t j ʊ m n ɛ m	s aː n aː t j oː n ɛ m
f l aː m ɪ l k ʊ m	f a m eː l ɪ k ʊ m
k ɔ mː ɛ r k j aː l ɛ m	k ɔ mː ɛ r k j aː l ɛ m
l a p ɪ d aː t j ʊ m n ɛ m	l a p ɪ d aː t j oː n ɛ m
k ɔ m p l ɛ m t ɪ w ʊ m	k ɔ m p l eː t iː w ʊ m
t eː l a m	t eː l a m
m ɛ t aː lː ɪ f ɛ r ʊ m	m ɛ t a lː ɪ f ɛ r ʊ m
d ɪ m ɛ t ɛ r ɛ	d iː m ɪ tː ɛ r ɛ
ɪ d oː n ɛ ʊ m	ɪ d oː n ɛu m
p l aː n ɛ t a m	p l a n eː t a m
k r aː t ɪ k ʊ l a m	k r aː t ɪ k ʊ l a m
s a l aː r j ʊ m	s a l aː r j ʊ m
a fː ɛ k t j oː n ɛ m	a fː ɛ k t j oː n ɛ m
l ɪ t ɛ	l iː t ɛ m
a l k j ɔ n	a l k y ɔ n ɛ m
f ɔ r t ɛ m	f ɔ r t ɛ m
b a l t ɛ ʊ m	b a l t ɛu m
m a g ɛ s t aː t ɛ m	m a j ɛ s t aː t ɛ m
k ʊ m p ɪ r ɛ	k oː n s p ʊ ɛ r ɛ
a b j ɛ k t j oː n ɛ m	a b ɪ ɛ k t j oː n ɛ m
k a rː ɪ k k ɛ m	k aː r ɪ k ɛ m
uː m ʊ s	h ʊ m ʊ m
g a l ɛ n a m	g a l eː n a m
a lː ɛ k t aː r ɛ	a lː ɛ k t aː r ɛ
r ʊ w ʊ m	r ʊ b ʊ m
ɪ n f l aː mː aː t j oː n ɛ m	iː n f l a mː aː t j oː n ɛ m
l a t ʊ m	l aː t ʊ m
a s ɛ lː a m	a s k ɛ lː a m
ɪ f ɔ r t ʊ n j ʊ m	iː n f ɔ r t uː n j ʊ m
ɪ r aː	iː r a m
p ɔ n d ɛ r oː s ʊ m	p ɔ n d ɛ r oː s ʊ m
k ɔ m ɛ r ɛ	k ɔ m ɛ d ɛ r ɛ
ɔ p r ɪ m ɛ r ɛ	ɔ pː r ɪ m ɛ r ɛ
t ɛ m p ɛ r j ɪ ɛ	t ɛ m p ɛ r ɪ ɛ m
t ʊ n d aː r ɛ	t ɔ n d eː r ɛ
ɪ n k ɔ n s t a n t ɛ m	ɪ ŋ k oː n s t a n t ɛ m
n ɔ w ɪ l ʊ n j ʊ m	n ɔ w ɪ l uː n j ʊ m
s t ʊ l t ʊ m	s t ʊ l t ʊ m
k ɔ n t ʊ m ɛ l j aː	k ɔ n t ʊ m eː l j a m
ɔ r d ɪ n aː t oː r	ɔ r d ɪ n aː t oː r ɛ m
w ɪ n k ʊ l aː r ɛ	w ɪ ŋ k ʊ l aː r ɛ
uː s ɛ r ɛ m	ɔ s t j aː r j ʊ m
ɔ fː ɪ k ɪ n a m	ɔ fː ɪ k iː n a m
l uː k ɪ n ʊ m l oː	ɛ lː y kʰ n j ʊ m
n ʊ m ɛ r aː r ɛ	n ʊ m ɛ r aː r ɛ
n ʊ k ɛ t ʊ m	n ʊ k eː t ʊ m
kʷ a d r ʊ m	kʷ aː d r ʊ m
f ɪ n ɪ	f iː n ɛ m
p a l p ɪ t aː r ɛ	p a l p ɪ t aː r ɛ
w ɪ k t ʊ m	w iː k t ʊ m
k ɔ l oː n ʊ m	k ɔ l oː n ʊ m
a k ɛ r b ʊ m	a k ɛ r b ʊ m
k ʊ n k ɛ r ɪ r	k ɔ ŋ kʷ iː r ɛ r ɛ
a k ɪ n ʊ m	a k ɪ n ʊ m
ɪ n t ɛ l ɪ g ɪ r ɛ	ɪ n t ɛ lː ɛ g ɛ r ɛ
l ʊ k ʊ m	l uː k j ʊ m
k ɔ n f ɛ r ɛ r ɛ	k oː n f ɛ rː ɛ
k a r ɔ t a m	k a r oː t a m
k ɔ mː ɪ sː j oː n ɛ m	k ɔ mː ɪ sː j oː n ɛ m
l ʊ k ɛ lː ʊ m	l ɔ k ɛ lː ʊ m
s ɪ ɪ l aː r ɛ	s ɪ g ɪ lː aː r ɛ
m uː s k ʊ l aː r ɛ	m uː s k ʊ l aː r ɛ m
r ʊ k ʊ m	r oː s k ɪ d ʊ m
j a d ɛ m	iː l ɛ
a r g uː t j a m	a r g uː t j a m
a b s t r ɛ r ɛ	a b s t r a h ɛ r ɛ
ɛ fː l ʊ ɪ r ɛ	ɛ fː l ʊ ɛ r ɛ
a nː ʊ n k j aː r ɛ	a nː uː n t j aː r ɛ
l a b r ʊ m	l a b r ʊ m
ɔ k ɪ d ɛ r ɛ	ɔ kː ɪ d ɛ r ɛ
s k uː r ɪ l ɛ	s k ʊ rː iː l ɛ m
p r ɛ t ɪ p ɪ t j ʊ m	p r aɪ k ɪ p ɪ t j ʊ m
ɪ n k ɛ n d ɛ r ɛ	ɪ ŋ k ɛ n d ɛ r ɛ
f uː n ɛ b r ɛ m	f uː n ɛ b r ɛ m
a ŋ d aː r ɛ	a m b ʊ l aː r ɛ
r ɪ k ɛ p t a m t oː r ɛ m	r ɛ k ɛ p t aː t oː r ɛ m
k ɛ l ɪ b eː	k aɪ l ɪ b ɛ m
l uː m ɪ n aː r j a m	l uː m ɪ n aː r ɛ
s ɪ l w ɛ s t r ɛ ɛ m	s ɪ l w ɛ s t r ɛ m
oː l ɪ r	h ɔ rː eː r ɛ
p ɛ d ɛ s t r ɛ m	p ɛ d ɛ s t r ɛ m
r ɪ s t aʊ r aː r ɛ	r ɛ s t aʊ r aː r ɛ
g a lː ɛ t a m	g a lː ɛ t a m
l ɛ k t ɪ k a m	l ɛ k t iː k a m
m uː s k ʊ l oː s ʊ m	m uː s k ʊ l oː s ʊ m
p a w ɪ l oː n ɛ m	p aː p ɪ l j oː n ɛ m
eː r ɛ d ɛ	h eː r eː d ɛ m
a k j oː n ɪ ɛ t ɛ r ɛ	a kː w ɪ eː s k ɛ r ɛ
t ɛ m p ɛ r aː r ɛ	t ɛ m p ɛ r aː r ɛ
s a g ɛ t aː r ɛ	s a g ɪ tː aː r ɛ
l ɔ ŋ g ɪ n kʷ ɪ t aː t ɛ m	l ɔ ŋ g ɪ ŋ kʷ ɪ t aː t ɛ m
f ɔ k a m	pʰ oː k a m
k ɔ n s ɔ l aː t j oː n ɛ m	k oː n s oː l aː t j oː n ɛ m
g r aː t ʊ m	g r aː t ʊ m
a ŋ ɛ lː oː	a ŋ n ɛ lː ʊ m
ɪ n k ʊ m n k ʊ sː ʊ m	ɪ ŋ k ɔ ŋ k ʊ sː ʊ m
w ɛ r t ɛ r ɛ	w ɛ r t ɛ r ɛ
p l aː n ɪ t j ɛ m	p l aː n ɪ t ɪ ɛ m
p ɪ l aː r ɛ	p ɪ l aː r ɛ
a s ɪ l ʊ m	a s y l ʊ m
l uː p aː n aː r ɛ	l ʊ p aː n a r
ɪ m p ɪ ŋ g ɛ r ɛ	ɪ m p ɪ ŋ g ɛ r ɛ
p r ɔ r ɔ g aː r ɛ	p r oː r ɔ g aː r ɛ
b ɛ s t j aː r j ʊ m	b eː s t j aː r j ʊ m
m uː r ɛ n a m	m ʊ r eː n a m
s ɔ p ʊ m r ɛ	s ɔ p oː r ɛ m
d ɔ r m ɪ t oː r j ʊ m	d ɔ r m iː t oː r j ʊ m
k ɔ n d uː k ɪ r ɛ	k ɔ n d uː k ɛ r ɛ
ɔ l aː r ʊ m	ɔ lː aː r j ʊ m
ɛ l ɪ m ɪ n a m t j oː n ɛ m	eː l ɪ m ɪ n aː t j oː n ɛ m
d ɛ l ɪ n kʷ ɛ r ɛ	d eː l ɪ ŋ kʷ ɛ r ɛ
m ɛ s uː r a m	m eː n s uː r a m
d ɪ p r ɛ n d ɛ r ɛ m	d eː p r ɛ h ɛ n d ɛ r ɛ
t r ʊ k ɛ	t r ʊ k ɛ m
m ʊ s aː r aː n ʊ m	m uː s a r aː n ɛu m
k oː n ʊ m	k oː n ʊ m
k ɔ aː b ɪ t a m r ɛ	k ɔ h a b ɪ t aː r ɛ
a b uː s aː r ɛ	a b uː t iː
ɛ k s t ɛ n d ɛ r ɛ	ɛ k s t ɛ n d ɛ r ɛ
d ʊ b l ʊ m	d ʊ p l ʊ m
s t r ɛ m ɛ m t ɛ r ɛ	t r ɛ m eː s k ɛ r ɛ
a nː aː l ɪ	a nː aː l ɛ m
a k t r ɪ k ɛ	aː k t r iː k ɛ m
ɪ nː ɔ k ʊ m	ɪ nː ɔ k ʊː m
n ɔ m n aː r ɛ	n oː m ɪ n aː r ɛ
b j ɛ n ɛ	b ɪ ɛ nː ɛ m
d ɪ g ɪ t aː l ɛ	d ɪ g ɪ t aː l ɛ m
g ɛ s t j oː n	g ɛ s t iː r ɛ
k ɛ l ɛ r ɛ	k ɛ l ɛ r ɛ m
k ɪ k ʊ t a m	k ɪ k uː t a m
f uː l m ɪ n a m r ɛ	f ʊ l m ɪ n aː r ɛ
d ɪ s k r ɪ m ɪ n aː t j oː n ɛ m	d ɪ s k r iː m ɪ n aː t j oː n ɛ m
k ɛ r t aː m ɛ m	k ɛ r t aː m ɛ n
d ɛ t ɛ r m ɪ n aː r ɛ	d eː t ɛ r m ɪ n aː r ɛ
r ɔ m aː k ɛ	r ʊ m ɪ k ɛ m
ɔ l ʊ m	ʊ l ʊ m
r uː g ɪ r ɛ	r uː g iː r ɛ
s ɛ r ʊ m m	s ɛ r ʊ m
k ɪ r k ʊ l aː r ɛ	k ɪ r k ʊ l aː r ɛ m
l aʊ r ʊ m k ɛ r aː s ʊ m	l aʊ r ɔ k ɛ r a s ʊ m
d ɪ ŋ n a m t j oː n ɛ m	d ɪ ŋ n aː t j oː n ɛ m
a kː uː s aː t oː r ɛ	a kː uː s aː t oː r ɛ m
p a l a m	p aː l a m
s ʊ b t r ɛ r ɛ	s ʊ b t r a h ɛ r ɛ
m ɛ d j aː l ɛ	m ɛ d j aː l ɛ m
s a l s a m	s a l s a m
k ɔ n s ɛ m kʷ ɪ r ɛ	k oː n s ɛ kʷ iː
w ɔ m ɪ t aː r ɛ	w ɔ m ɪ t aː r ɛ
f ɪ n kː aː r ɛ	f iː g ɛ r ɛ
s p ɛ k ʊ j ʊ m	s p ɛ k l ʊ m
k ɔ n d ɛ n s aː t j oː n ɛ m	k ɔ n d eː n s aː t j oː n ɛ m
s ɛ k r ɪ t ʊ m	s k r iː p t ʊ m
ɪ n k ɛ n s ʊ m	ɪ ŋ k eː n s ʊ m
s a n t j oː n	s aː ŋ k t j oː n ɛ m
p a l aː r ʊ m	p a l ɛ aː r j ʊ m
ɪ l ɛ s ʊ m	ɪ lː aɪ s ʊ m
t ʊ r m a m	t ʊ r m a m
m ɪ l ɪ t aː r ɛ	m iː l ɪ t aː r ɛ
k r ʊ lː a m r ɛ	k ɔ rː ʊ ɛ r ɛ
ɛ k l ɪ p sː ɛ	ɛ k l iː p s ɛ m
a pː r ɔ b aː t j oː n ɛ m	a pː r ɔ b aː t j oː n ɛ m
ɔ l ʊ m	ɔ l ʊ m
l ɪ b ɛ r aː t j oː n ɛ m	l iː b ɛ r aː t j oː n ɛ m
kʷ a d r a m g ɛ s ɪ m ʊ m	kʷ aː d r aː g eː s ɪ m ʊ m
w a lː ʊ m	w a lː ʊ m
f ɪ d ʊ m	f iː d ʊ m
ɪ n s ʊ l t ʊ m	iː n s ʊ l t ʊ m
p r ɛ m ʊ m n ɪ t ʊ m r ɛ m	p r aɪ m ɔ n ɪ t oː r ɛ m
r ɛ d ɪ k g ɛ r ɛ	r ɛ d ɪ g ɛ r ɛ
m eː n s a m	m eː n s a m
k ʊ j	k uː j ʊ m
r a m ʊ m	r aː m ʊ m
ɛ k k ɛ lː ɛ n t j a m	ɛ k s k ɛ lː ɛ n t j a m
g uː s t aː t j oː n ɛ m	g ʊ s t aː t j oː n ɛ m
d ɛ k s t r ʊ m	d ɛ k s t r ʊ m
p r ɔ k ɛ d ɛ r ɛ	p r oː k eː d ɛ r ɛ
uː r b ɛ m	ʊ r b ɛ m
uː l t ɛ r j ʊ m r ɛ	ʊ l t ɛ r j oː r ɛ m
k ɔ n s ʊ m aː t j oː n ɛ m	k oː n s ʊ mː aː t j oː n ɛ m
p r ɛ s k r ɪ w ɪ r ɛ m	p r aɪ s k r iː b ɛ r ɛ
k ɔ n t r ɪ s t aː r ɛ	k ɔ n t r iː s t aː r ɛ
t ʊ r t ʊ r m ʊ m	t ʊ r t ʊ r ɛ m
k ɔ n s ɛ r w aː t j oː n ɛ m	k oː n s ɛ r w aː t j oː n ɛ m
d uː b j ʊ m	d ʊ b j ʊ m
s ɔ l aː r ɛ	s oː l aː r ɛ m
t r a n s m ɪ t ɛ r ɛ m	t r aː n s m ɪ tː ɛ r ɛ
ɪ m p uː l s ɪ w ʊ m	ɪ m p ʊ l s iː w ʊ m
kʷ ɪ n t ʊ m	kʷ iː n t ʊ m
a p r ɪ k ʊ m	a p r iː k ʊ m
m uː t w ʊ m m	m uː t ʊː m
p r ɔ w ɛ d eː r ɛ	p r oː w ɪ d eː r ɛ
k ɪ d aː	k iː d a m
ɛ k s aː l t a m r ɛ	ɛ k s a l t aː r ɛ
m ɛ s t ɛ r ɛ	m ɪ n ɪ s t ɛ r j ʊ m
r ɛ t ɛ	r eː t ɛ
g ɛ n ɛ r ʊ m	g ɛ n ʊ s
f ɛ n d ɛ r ɛ	f ɪ n d ɛ r ɛ
p ɛ r ɪ k ʊ l oː s ʊ m	p ɛ r iː k ʊ l oː s ʊ m
