l ɪ ʊ d a t ɔ r ɛ	l aʊ d aː t oː r ɛ m
l aː r g ʊ m	l a r g ʊ m
g ɛ t aː r ɛ	j a k t aː r ɛ
m aː g ɛ s t aː t ɛ m	m a j ɛ s t aː t ɛ m
k ɔ r ɛ	k ɔ r
a s ɪ m ɪ l aː r ɛ	a sː ɪ m ʊ l aː r ɛ
d aː nː a m t ʊ m	d a m n aː t ʊ m
g l aʊ k ʊ m	g l aʊ k ʊ m
ɛ k ʊ m	ɛ kː ʊ m
k aː mː ɪ n ʊ m	k a mː iː n ʊ m
p l ɛ n ɪ t ʊ d ɛ m	p l eː n ɪ t uː d ɪ n ɛ m
k ɪ n t uː r a m	k ɪ ŋ k t uː r a m
k ɔ n s ɛ r w aː t j oː n ɛ m	k oː n s ɛ r w aː t j oː n ɛ m
ɛ l ɛ g aː n t ɛ m	eː l ɛ g a n t ɛ m
a d ʊ n t ʊ m	a d j ʊ ŋ k t ʊ m
k aː l ɪ fː ʊ m	k a l iː pʰ a m
f r ɛ kʷ ɛ n t ɛ m	f r ɛ kʷ ɛ n t ɛ m
r ɔ t aː r ɛ	r ɔ t aː r ɛ
p ɛ r ɪ t aː r s	p ɪ g r ɪ t aː r iː
p aː r ɪ ɛ t aː l ɛ	p a r ɪ ɛ t aː l ɛ m
s a b l ʊ m	s a b ʊ l ʊ m
p r ɛ w aː l eː r ɛ	p r aɪ w a l eː r ɛ
s k ɔ l ɔ p ɛ n d r a m	s k ɔ l ɔ p ɛ n d r a m
r ɔ g a k aː	r oː r ɛ m
ɪ n f aː n d ʊ m	iː n f a n d ʊ m
s ʊ b mː ɛ r g ɛ r ɛ	s ʊ mː ɛ r g ɛ r ɛ
k ʊ lː ɛ k ʊ j ʊ m	k aʊ l ɪ k ʊ l ʊ m
g ɛ r ɛ r ɛ	g ɛ r ɛ r ɛ
d ɛ t ɛ s t aː t j oː n ɛ m	d eː t ɛ s t aː t j oː n ɛ m
s ɪ r a m	s eː r ʊ m
d ɪ s t ɛ n d ɛ r ɛ	d ɪ s t ɛ n d ɛ r ɛ
k ʊ ɛ r ʊ m	k ɔ r j ʊ m
g l ʊ t ɪ n ɛ	g l uː t ɛ n
t ɔ r t ɪ l ɛ	t ɔ r t ɪ l ɛ m
k r ɔ k ʊ m	k r ɔ k ʊ m
w ɛ s t ɪ m ɛ n t ʊ m	w ɛ s t iː m ɛ n t ʊ m
s ɔ m ɪ aː r ɛ m	s a g m aː r j ʊ m
b r ɪ t aː nː ɪ k ʊ m	b r ɪ t a nː ɪ k ʊ m
d ɛ s ɪ n ɛ n t a m	d eː s ɪ n ɛ n t j a m
p r ɔ r ɔ g aː t j ʊ m n ɛ m	p r oː r ɔ g aː t j oː n ɛ m
k ʊ rː ɛ a m	k ɔ rː ɪ g j a m
g ʊ b ɪ l aː r ɛ	j uː b ɪ l aː r ɛ
k r ɛ m aː r ɛ	k r ɛ m aː r ɛ
a f l ɛ n t j a m	a fː l ʊ ɛ n t j a m
w uː l n ɛ r aː r ɛ	w ʊ l n ɛ r aː r ɛ
a pː a r iː r ɛ	a pː aː r eː r ɛ
s aː t ɪ r a m	s a t ɪ r a m
p a m p aː n ʊ m	p a m p ɪ n ʊ m
w oː l a r ɛ	w ɔ l aː r ɛ
ɔ lː aː r ʊ m	ɔ lː aː r j ʊ m
a k r ɪ t ʊ d ɛ m	aː k r ɪ t uː d ɪ n ɛ m
p r ɔ b l ɛ m aː t ɪ k ʊ m	p r ɔ b l eː m a t ɪ k ʊ m
p a l oː	p aː l ʊ m
k a m p ɛ s t r ɛ m	k a m p ɛ s t r ɛ m
t ʊ sː ɛ r ɛ	t ʊ sː iː r ɛ
k aː p t uː r a m	k a p t uː r a m
k aː n ʊ m	k aː n ʊ m
t aː k sː aː t j ʊ m n ɛ m	t a k s aː t j oː n ɛ m
s ʊ p l ɪ t j ʊ m	s ʊ pː l ɪ k j ʊ m
s ʊ r k ɪ r ɛ	s a r k iː r ɛ
a s k ɛ n d ɛ r ɛ	a s k ɛ n d ɛ r ɛ
a m ɪ k t ʊ m	a m ɪ k t ʊ m
a l aː k r ɪ t aː t ɛ m	a l a k r ɪ t aː t ɛ m
r aː s k aː r ɛ	r aː d ɛ r ɛ
w ɪ n k ʊ l aː r ɛ	w ɪ ŋ k ʊ l aː r ɛ
d ɪ g ɪ t aː l ɛ	d ɪ g ɪ t aː l ɛ m
d ɛ r ɔ m p ɛ r ɛ	d iː r ʊ m p ɛ r ɛ
a d ɪ k t j oː n ɛ m ɛ	a dː ɪ k t j oː n ɛ m
l ʊ b r ɪ k ɪ t ɛ m	l uː b r ɪ k ɪ t aː t ɛ m
a d ʊ n k ʊ m	a d ʊ ŋ k ʊ m
f aː k ʊ n d j a m	f aː k ʊ n d j a m
a n ɛ l ʊ m	a nː ɪ k ʊ l ʊ m
t ɛ t ʊ m	t eː k t ʊ m
p l aː g j aː r ɛ	p l a g j aː r ɛ
a ŋ ɛ lː a m	a ŋ n ɛ lː a m
t ɔ r k ɛ r ɛ	t ɔ r kʷ eː r ɛ
d ɪ s k ɪ ŋ g ɛ r ɛ	d ɪ s k ɪ ŋ g ɛ r ɛ
a k t aː r ɛ	aː k t w aː r ɛ
ɪ t uː d ɪ n ɛ	t uː d ɪ n ɛ m
ɛ s ɛ r k ɪ t ʊ m	ɛ k s ɛ r k ɪ t ʊ m
kʷ aː d r ʊ m	kʷ aː d r ʊ m
n eː m r ɛ t ɪ r	n ɪ g r eː s k ɛ r ɛ
s p oː ŋ g a m	s p ɔ ŋ g j a m
a l t ɛ	a l tʰ aɪ a m
k aː n oː n ɛ m	k a n ɔ n ɛ m
a sː ɛ r ɪ r ɛ	a sː ɛ r ɛ r ɛ
ɪ m b ɛ k ɪ lː ɪ t aː t ɛ m	ɪ m b eː k ɪ lː ɪ t aː t ɛ m
k ɔ lː ɛ k t a m	k ɔ lː eː k t a m
k oː l t ɪ ɛ m	k ʊ l k ɪ t a m
k ɔ m p l aː k ɛ r ɛ	k ɔ m p l a k eː r ɛ
ɛ k s p ɪ r aː r ɛ	ɛ k sː p iː r aː r ɛ
m ɛ r k aː r ɛ	m ɛ r k aː r iː
m ɔ n a s t ɛ r ʊ	m ɔ n a s t eː r j ʊ m
r ɛ k ɛ d ɛ r ɛ	r ɛ k eː d ɛ r ɛ
s uː b ɪ r ɛ	s ʊ b iː r ɛ
g aː t a m	k a tː a m
m ɪ ŋ g ɛ r ɛ	m ɪ ŋ g ɛ r ɛ
ɛ t ʊ m	eː t ʊ m
s ɔ b r ɪ n ʊ m	s oː b r iː n ʊ m
f ɪ m b r j aː t ʊ m	f ɪ m b r j aː t ʊ m
ɛ r ɔ ɛ m	h eː r oː ɛ m
k ɛ r w ɪ n ʊ m	k ɛ r w iː n ʊ m
k ɔ n t r aː dː ɪ k t oː r ɛ	k ɔ n t r aː d ɪ k t oː r ɛ m
ɔ b l ɪ d aː	ɔ b l iː w ɪ s k iː
d ʊ w eː r ɛ	d eː b eː r ɛ
k r oː r ɛ	k r ʊ oː r ɛ m
a s k ɛ n s j oː n ɛ m	a s k eː n s j oː n ɛ m
m aː l pʰ ɛ r ɛ	m a l ɛ f a k ɛ r ɛ
ɛ k s ɛ k r aː r ɛ	ɛ k sː ɛ k r aː r iː
l ɛ mː a m	l ɛ mː a
k ɛ d r ʊ m	k ɛ d r ʊ m
a l t ɛ r k aː t j oː n ɛ m	a l t ɛ r k aː t j oː n ɛ m
k a t ɛ lː ʊ m	k a t ɛ lː ʊ m
n ɔ m ɪ n aː t j oː n ɛ	n oː m ɪ n aː t j oː n ɛ m
j uː r a t oː r ɛ	j uː r aː t oː r ɛ m
s ɔ l w ɛ r ɛ	s ɔ l w ɛ r ɛ
ɪ n w ɪ d j oː s ʊ m	ɪ n w ɪ d j oː s ʊ m
d s aː b ʊ rː a m	s a b ʊ rː a m
w ɪ p ʊ r a m	w iː p ɛ r a m
a n aː l ɪ s iː	a n a l y s ɛ m
f l ɛ k t ɪ r ɛ	f l ɛ k t ɛ r ɛ
ɪ n f l aː mː aː t j oː n ɛ m	iː n f l a mː aː t j oː n ɛ m
a r k ɛ t ɪ p ʊ m	a r kʰ ɛ t y p ʊ m
a k ɪ d j a m	a k eː d j a m
ɔ s p ɪ t j ʊ m	h ɔ s p ɪ t j ʊ m
a w ʊ m g aː r ɛ	a d w ɔ k aː r ɛ
ɪ n ʊ m aː n ɪ t aː t ɛ m	ɪ n h uː m aː n ɪ t aː t ɛ m
a r ɪ j ʊ l ʊ m	h a r ɪ ɔ l ʊ m
l ɪ m ʊ m	l iː m ʊ m
d ɪ s t ɔ r k ɛ r ɛ	d ɪ s t ɔ r kʷ eː r ɛ
k ʊ k ɪ n aː r ɛ	k ɔ kʷ iː n aː r ɛ
d ɛ s k r ɪ p t j oː n ɛ m	d eː s k r iː p t j oː n ɛ m
m ɔ l aː r ɛ	m ɔ l aː r ɛ m
d ɛ s k r ɪ w ɛ r ɛ	d eː s k r iː b ɛ r ɛ
ɪ s k ʊ m	ɪ s k ʊ m
s a m b ʊ k ʊ m	s a m b uː k ʊ m
r ɛ p ɛ lː ɛu r ɛ	r ɛ p ɛ lː ɛ r ɛ
s ɔ lː aː k	s oː l aː k j ʊ m
p a s t ɪ n aː k	p a s t ɪ n aː k a m
s ɛ n s aː t j oː n ɛ m	s eː n s aː t j oː n ɛ m
p ʊ l w ɪ n aː r ɛ	p ʊ l w iː n a r
a l ʊ m nː ʊ m	a l ʊ m n ʊ m
g ɛ t ʊ m	j a k t ʊ m
ɪ n f l ɪ k t j oː n ɛ m	ɪ n f l ɪ k t j oː n ɛ m
f ɛ t aː r ɛ	f eː t aː r ɛ
l uː k b r ɪ k aː r ɛ m	l uː k ʊ b r aː r ɛ
a b r ɔ t aː n ʊ m	a b r ɔ t ɔ n ʊ m
k ʊ w ɪ l	k ʊ b iː l ɛ
k aː p ɪ t ʊ m	k a p ɪ t ʊ l ʊ m
w ɛ r s ɪ f ɪ k aː r ɛ	w ɛ r s ɪ f ɪ k aː r ɛ
a d mː ɪ n ɪ s t r aː r ɛ	a d m ɪ n ɪ s t r aː r ɛ
g r aː t ʊ m	g r aː t ʊ m
b aː kː a l ɪ r aː t ʊ m	b a kː a l aʊ r ɛ a t ʊ m
k ɔ l ʊ m b ɪ n ʊ m	k ɔ l ʊ m b iː n ʊ m
a t l aː n t ɪ k ʊ m	aː t l a n t ɪ k ʊ m
k ɛ l aː r ɛ	k eː l aː r ɛ
m ɔ r ɪ b ʊ n d ʊ m	m ɔ r ɪ b ʊ n d ʊ m
l a ŋ gʷ ɪ d ʊ m	l a ŋ gʷ ɪ d ʊ m
k oː s ʊ m	k ɔ k s ʊ m
k a n t oː r ɛ	k a n t oː r ɛ m
a r g ɪ n t oː s ʊ m	a r g ɛ n t oː s ʊ m
k ɔ n s t ɪ t ʊ t ɪ w ʊ m	k ɔ n s t ɪ t uː t ɪ w ʊ m
ɪ n ɔ s k ɛ r ɛ	ɪ ŋ n oː s k ɛ r ɛ
t ɪ m oː n ɛ m	t eː m oː n ɛ m
j uː d ɪ k a t oː r ɛ	j uː d ɪ k aː t oː r ɛ m
ɪ m b ɛ k ɪ l ɛ	ɪ m b eː k ɪ lː ʊ m
b r aː k a m	b r aː k a m
d ɔ m ɛ s t ɪ k ʊ m	d ɔ m ɛ s t ɪ k ʊ m
ɛ f ɛ k t aː ɛ r ɛ	ɛ fː ɪ k ɛ r ɛ
a r b ɛ t ʊ m	a r b ʊ t ʊ m
ɔ b j ʊ m	ɔ b w j ʊ m
t r aː l a m	t r aː g ʊ l a m
s k ʊ rː ɛ r ɛ	ɛ k s k ʊ rː ɛ r ɛ
l ɛ n aː t oː r ɛ	l ɪ ŋ n aː t oː r ɛ m
k ɔ m p aː s ɪ b l ɛ	k ɔ m p a sː ɪ b ɪ l ɛ m
m aː t r ɪ t ɪ t j ʊ m	m aː t r ɪ k iː d j ʊ m
a g r ɪ m ɛ n s oː r ɛ	a g r iː m eː n s oː r ɛ m
ɪ n s ɪ n w aː r ɛ	iː n s ɪ n w aː r ɛ
ɔ r d ɪ n aː t oː r	ɔ r d ɪ n aː t oː r ɛ m
w ɪ s aː r ɛ	w iː s ɛ r ɛ
t ʊ m ɪ d ʊ m	t ʊ m ɪ d ʊ m
l ɪ n ɪ t aː r ɛ	l iː m ɪ t aː r ɛ
g ɔ s j ʊ m	g ɛu s j aː s
p r ɛ d a t oː r ɛ	p r aɪ d aː t oː r ɛ m
r ɛ t j aː r j ʊ m	r eː t j aː r j ʊ m
f r uː k t ʊ m	f r uː k t ʊ m
p ʊ t aː r ɛ m	p ʊ t aː r ɛ
p r ɛ ɛ m b ʊ l ʊ m	p r aɪ a m b ʊ l ʊ m
k ɔ rː ɔ s j oː n ɛ	k ɔ rː oː s j oː n ɛ m
w aː r ɪ ɛ t aː t ɛ m	w a r ɪ ɛ t aː t ɛ m
k a m aː r a m	k a m a r a m
b ʊ w aː r ʊ m	b ɔ w aː r j ʊ m
p ɪ n t ʊ m	p ɪ k t ʊ m
ɔ n ɪ s ɛ	ɔ n ʊ s
k ɔ n t ɪ n ʊ m	k ɔ n t ɪ n ʊː m
g ɪ b ʊ m	g ɪ bː ʊ m
p ʊ p ɪ lː a m	p uː p ɪ lː a m
k aː n ɪ n ʊ m	k a n iː n ʊ m
l ɪ m oː s ʊ m	l iː m oː s ʊ m
f r aː t ɛ r n ɪ t aː t ɛ m	f r aː t ɛ r n ɪ t aː t ɛ m
s aː l s a m	s a l s a m
k aː d aː w ɛ r ɛ	k a d aː w ɛ r
ɛ k s aː m ɪ n aː r ɛ	ɛ k s aː m ɪ n aː r ɛ
s ɪ t aː s j oː n ɛ m	k ɪ t aː t j oː n ɛ m
a k ɪ n ʊ m	a k ɪ n ʊ m
a f ɔ g aː r ɛ	ɔ fː oː k aː r ɛ
d ɛ n s aː r ɛ	d eː n s aː r ɛ
f l ʊ w m	f l ʊ w j ʊ m
ɛ g r ɛ g ɪ ʊ m	eː g r ɛ g j ʊ m
g ɛ n t ɪ l ɪ t a m t ɛ m	g ɛ n t iː l ɪ t aː t ɛ m
ɪ n d ɪ ŋ n ɪ t aː t ɛ m	ɪ n d ɪ ŋ n ɪ t aː t ɛ m
a t ɛ n t ʊ m m	a tː ɛ n t ʊ m
f ʊ ŋ g oː s ʊ m	f ʊ ŋ g oː s ʊ m
s ɛ k r ɪ t ʊ m	s k r iː p t ʊ m
n ɛ f aː r j ʊ m	n ɛ f aː r j ʊ m
d ɛ s t ɪ n aː r ɛ	d eː s t ɪ n aː r ɛ
f aː b ɛ lː a m	f aː b ɛ lː a m
a r k ɛ r ʊ m	a r k w aː r j ʊ m
k ɔ n mː ɛ m ɔ r aː t j oː n ɛ m	k ɔ mː ɛ m ɔ r aː t j oː n ɛ m
k ɪ p a m	k eː p a m
l oː m t a m	l uː t ɛu m
ɛ f ɪ k aː t ɪ t aː t ɛ m	ɛ fː ɪ k aː k ɪ t aː t ɛ m
f ɛ d ɛ m	f ɪ d ɛ m
p a k aː r ɛ	p aː k aː r ɛ
p l aː n ɛ t a m	p l a n eː t a m
p r ɛ n ʊ m	p r aɪ ŋ n aː t ɛ m
f l ɛ mː a m	pʰ l ɛ g m a
ɪ m b ɪ r ɛ	ɪ m b ʊ ɛ r ɛ
d ɛ n ʊ d aː t j oː n ɛ m	d eː n uː d aː t j oː n ɛ m
a m b ʊ s	a m b oː s
k ɔ lː ɛ k t j oː n ɛ m	k ɔ lː eː k t j oː n ɛ m
ʊ r t ɪ k aː r j a m	ʊ r t iː k aː r j a m
b ʊ k ɪ m ɛ	b uː k ɪ n ʊ m
t ɔ m ʊ m	t ɔ m ʊ m
p a g a n t aː t a m	p aː g aː n ɪ t aː t ɛ m
n ɛ r w ʊ m	n ɛ r w ʊ m
a d ɪ p ɛ m	a d ɪ p ɛ m
p aː t r j a m	p a t r j a m
r j ɛ aː l ɪ t aː t ɛ m	r ɛ aː l ɪ t aː t ɛ m
a b ɔ m aː s ʊ m	a b ɔ m aː s ʊ m
s uː p ɛ r j oː r ɛ	s ʊ p ɛ r j oː r ɛ m
l aː m ɛ n t ʊ m	l aː m ɛ n t ʊ m
t ɔ r p ɛ d ʊ m	t ɔ r p eː d ɪ n ɛ m
p ʊ l w ɛ r ɪ zː aː r ɛ	p ʊ l w ɛ r iː zː aː r ɛ
d ɛ k l ɪ n aː r ɛ	d eː k l iː n aː r ɛ
kʷ aː t r aː g ɛ s ɪ m ʊ m	kʷ aː d r aː g eː s ɪ m ʊ m
ɪ n s ɛ m n aː r ɛ	iː n s ɪ ŋ n aː r ɛ
w ɔ s	w oː s
k aː n ɪ k ʊ l a m	k a n iː k ʊ l a m
b r aː k ɛ s	b r aː k aː s
g aː n ɪ r ɛ	g a nː iː r ɛ
a ɛ r ɛu ʊ m	aː ɛ r j ʊ m
s aː sː ʊ m	s a k s ʊ m
f ʊ n ɪ k ʊ l ʊ m	f uː n ɪ k ʊ l ʊ m
s ʊ g ɛ k t ʊ m	s ʊ b ɪ ɛ k t ʊ m
ɛ m ɔ l ʊ m ɛ n t ʊ m	eː m ɔ l ʊ m ɛ n t ʊ m
t ʊ rː ɛ m	t ʊ rː ɛ m
m ʊ l t ɪ p l ɪ k aː t j oː n ɛ	m ʊ l t ɪ p l ɪ k aː t j oː n ɛ m
a l t aː r ɛ	a l t a r ɛ m
p ɪ n t uː r a m	p ɪ k t uː r a m
ɪ m p ɛ lː ɛu r ɛ	ɪ m p ɛ lː ɛ r ɛ
a k k ɛ n t ʊ m	a kː ɛ n t ʊ m
s a l t ʊ m	s a l t ʊ m
oː w eː j a m	ɔ w ɪ k ʊ l a m
ɪ b r ɪ d ʊ m	h y b r ɪ d a m
w ɛ s k ɛ m	w eː s k ʊ m
d ɛ p l ɔ r aː r ɛ	d eː p l oː r aː r ɛ
d aː m b ʊ l aː t j oː n ɛ m	d ɛ a m b ʊ l aː t j oː n ɛ m
a n ɪ m ʊ m	a n ɪ m ʊ m
k aː p ɪ t ʊ l aː t j oː n ɛ m	k a p ɪ t ʊ l aː t j oː n ɛ m
k aʊ d aː l ɛ	k aʊ d aː l ɛ m
a r k aː n ʊ m	a r k aː n ʊ m
f l oː r iː r ɛ	f l oː r eː r ɛ
ɔ r aː t j oː n ɛ m	oː r aː t j oː n ɛ m
r ɛ ʊ m a m	r h ɛu m a
k ɔ m p ɛ l ɛu r ɛ	k ɔ m p ɛ lː ɛ r ɛ
d ɪ k aː k ɛ	d ɪ k aː k ɛ m
k uː p r ɛ m k	k uː p r ʊ m
k r ʊ d ɛ l ɛ	k r uː d eː l ɛ m
ɪ n ɛ b r j aː r ɛ	ɪ n eː b r j aː r ɛ
a g ɪ t aː t oː r ɛ	a g ɪ t aː t oː r ɛ m
a kʷ ɪ l ɪ n ʊ m	a kʷ ɪ l iː n ʊ m
t aʊ r ɪ f ɔ r m ɛ	t aʊ r ɪ f oː r m ɛ m
r a n k oː r ɛ	r a ŋ k oː r ɛ m
a n aː r k j a m	a n a r kʰ j a m
ɪ n k a n t aː r ɛ	ɪ ŋ k a n t aː r ɛ
l a ŋ gʷ oː r ɛ	l a ŋ gʷ oː r ɛ m
f ɪ g uː r a m	f ɪ g uː r a m
l oː m b ʊ m	l ʊ m b ʊ m
b aː r b uː l ɛ m	b a r b ʊ l a m
f uː lː ɪ g ɪ n ɛ	f uː l iː g ɪ n ɛ m
a m p l ɪ t uː d ɪ	a m p l ɪ t uː d ɪ n ɛ m
a s k r ɪ w ɛ r ɛ	aː s k r iː b ɛ r ɛ
n aː f t a m	n a pʰ tʰ a m
k ɪ n ɛ m	k y ŋ n ʊ m
d ɪ g ɪ t aː r ɛ	d ɪ g ɪ t aː r ɛ
r oː t ɛ lː a m	r ɔ t ɛ lː a m
ɪ n s t aʊ r aː r ɛ	iː n s t aʊ r aː r ɛ
n ɛ g ɔ t j aː t j oː n ɛ m	n ɛ g oː t j aː t j oː n ɛ m
t r a n s ɪ r ɛ	t r aː n s iː r ɛ
l ɪ b ɪ d ʊ m	l ɪ b iː d ɪ n ɛ m
l ɛ t ʊ m	l eː k t ʊ m
ɛ k s t ɪ ŋ gʷ ɛ r ɛ	ɛ k s t ɪ ŋ gʷ ɛ r ɛ
ɪ m p ɛ r j ʊ m	ɪ m p ɛ r j ʊ m
a lː ʊ d ɪ r ɛ	a lː uː d ɛ r ɛ
ɔ r ɪ g ɪ n aː r j ʊ m	ɔ r iː g ɪ n aː r j ʊ m
n aʊ s	n aʊ s j a m
p j oː	p j ʊ m
ɔ t r ɛ m	ʊ t r ʊ m
m ʊ n ɪ t j oː n	m uː n iː t j oː n ɛ m
f aː k aː l ɛ	f a k j aː l ɛ m
ɛ d ɪ k ɔ l a m	aɪ d ɪ k ʊ l a m
f eː mː ɪ n a m	f eː m ɪ n a m
f aː m a m	f aː m a m
f ɛ r aː t ʊ m	f ɛ rː aː t ʊ m
a kː ʊ m ʊ l aː t j oː n ɛ m	a kː ʊ m ʊ l aː t j oː n ɛ m
m ɪ r t ɪ lː ʊ m	m y r t ɪ lː ʊ m
k aː rː ɪ k k ɛ m	k aː r ɪ k ɛ m
w ɛ r m ɛ m	w ɛ r m ɛ m
n uː t r ɪ k aː r ɛ	n uː t r iː k aː r ɛ
ʊ l t ɔ r ɛ	ʊ l t oː r ɛ m
f ɛ s t ʊ m	f eː s t ʊ m
a ŋ d aː r ɛ	a m b ʊ l aː r ɛ
t ɛ n ɛ b r ɛ s	t ɛ n ɛ b r aː s
t r a n s ɪ g ɛ r ɛ	t r aː n s ɪ g ɛ r ɛ
k ɪ r k uː l aː r ɛ	k ɪ r k ʊ l aː r ɛ
k aː d ʊ k ʊ m	k a d uː k ʊ m
p ɛ t ʊ m	p eː d ɪ t ʊ m
a s t ʊ r ɛ	a s t ʊ r ɛ m
k r ɪ m ɪ n ɛ	k r iː m ɛ n
h ɛ lː ʊ m	ɛ lː ʊ m
d ɔ m aː r ɛ	d ɔ m aː r ɛ
s ɛ f ɪ r ʊ m	z ɛ pʰ y r ʊ m
ɛ k s k l ʊ d ɛ r ɛ	ɛ k s k l uː d ɛ r ɛ
s ɛ n aː t ʊ m	s ɛ n aː t ʊ m
w ɪ t uː l ʊ	w ɪ t ʊ l ʊ m
ɪ l ʊ t ɪ r ɛ	ɪ lː uː d ɛ r ɛ
f ʊ l aː k a m	f ʊ l ɪ k a m
k ɔ n t ɛ n t j oː n ɛ m	k ɔ n t ɛ n t j oː n ɛ m
r ɛ l aː k s aː t j oː n ɛ m	r ɛ l a k s aː t j oː n ɛ m
m a n t ɪ p m j ʊ m	m a ŋ k ɪ p j ʊ m
p aː g ɛ lː a m	p aː g ɛ lː a m
w ɪ s ɪ b ɪ l ɪ t aː d ɛ m	w iː s ɪ b ɪ l ɪ t aː t ɛ m
ɔ pː oː n r ɛ	ɔ pː oː n ɛ r ɛ
k ʊ lː a m	k uː n a m
ʊ s ɪ t aː r ɛ	uː s ɪ t aː r iː
ɛ d ɪ l	aɪ d iː l ɛ m
uː d ɛ m	uː d ʊ m
ɪ n t ɛ rː ʊ p t j oː n ɛ m	ɪ n t ɛ rː ʊ p t j oː n ɛ m
b aː p t ɪ s t a m	b a p t ɪ s t a m
k r ɪ t ɪ k ʊ m	k r ɪ t ɪ k ʊ m
t r aː m a m	t r aː m a m
p aː r t ʊ r ɪ n r ɛ	p a r t ʊ r iː r ɛ
k aː n ɔ r ʊ m	k a n oː r ʊ m
b a r b aː t ʊ m	b a r b aː t ʊ m
t r ɪ k ɛ	t r iː k ɛ m
f ɪ d aː r ɛ	f iː d ɛ r ɛ
p r ɛ s aː g j aː r ɛ	p r aɪ s aː g iː r ɛ
w oː m ɪ t ʊ m	w ɔ m ɪ t ʊ m
ɔ kː l ʊ d ɛ r ɛ	ɔ kː l uː d ɛ r ɛ
a l ɛ aː	aː l ɛ a m
d ɛ s ɔ l aː r ɛ	d eː s oː l aː r ɛ
k ɔ n s k ɛ j ɛ n t j a m	k oː n s k ɪ ɛ n t j a m
f ʊ l w ʊ m	f ʊ l w ʊ m
d ɛ n t aː l ɛ	d ɛ n t aː l ɛ m
p ɛ k uː n j aː r j ʊ m	p ɛ k uː n j aː r j ʊ m
s ɛ d ɛ m	s eː d ɛ m
ɔ l oː r ɛ	ɔ l oː r ɛ m
ɪ n w ɛ r t ɪ r ɛ	ɪ n w ɛ r t ɛ r ɛ
oː k s j oː n ɛ m	uː ŋ k t j oː n ɛ m
d ɛ d uː k t j oː n ɛ m	d eː d ʊ k t j oː n ɛ m
ɛ fː ɛ m ɪ n a m r ɛ	ɛ fː eː m ɪ n aː r ɛ
ɛ k s ɛ r k ɛ r ɛ	ɛ k s ɛ r k eː r ɛ
k ɪ r k ʊ n l ɔ k ʊ t j ɔ n ɛ	k ɪ r k ʊ m l ɔ k uː t j oː n ɛ m
a d ɔ r m ɪ r ɛ	a dː ɔ r m iː r ɛ
a s ɔ l aː r ɛ	a sː ɔ l aː r ɛ
d ɛ l ɪ n kʷ ɛ r ɛ	d eː l ɪ ŋ kʷ ɛ r ɛ
p ɔ p l ɪ t ɛ m	p ɔ p l ɪ t ɛ m
m ɪ t ɪ g aː t j oː n ɛ m	m iː t ɪ g aː t j oː n ɛ m
k ɔ n w ɔ k aː t j oː n ɛ m	k ɔ n w ɔ k aː t j oː n ɛ m
r ɛ w ɛ r b ɛ r aː r ɛ	r ɛ w ɛ r b ɛ r aː r ɛ
k ɔ n t r ɪ b ʊ ɪ r ɛ	k ɔ n t r ɪ b ʊ ɛ r ɛ
a m a l g aː m a	a m a l g a m a
f ɛ rː oː l ʊ m	w ɛ r ɪ k ʊ l ʊ m
k aː s t aː n	k a s t a n ɛ a m
a b uː s aː r ɛ	a b uː t iː
ɛ t ɪ f ɪ k aː t j oː n ɛ m	aɪ d ɪ f ɪ k aː t j oː n ɛ m
ɛu s t ʊ m	ɪ s t ʊ m
uː r ʊ m	uː r ʊ m
ɛ k s aː l t aː r ɛ	ɛ k s a l t aː r ɛ
k ɛ n s ʊ r a m	k eː n s uː r a m
p ɔ sː ɛ sː oː r ɛ	p ɔ sː ɛ sː oː r ɛ m
p ɛ s k aː r ʊ m	p ɪ s k aː r j ʊ m
ɪ n k ʊ r w aː r ɛ	ɪ ŋ k ʊ r w aː r ɛ
s ɛ pː ʊ lː aː r ɛ	s ɛ p ɛ l iː r ɛ
d ɛ r ɪ s oː r j ʊ m	d eː r iː s oː r j ʊ m
ɛ n s ʊ g aː r ɛ	ɛ k sː uː k aː r ɛ
m aː t ɛ r n ʊ m m	m aː t ɛ r n ʊ m
ɪ n f ɪ m ʊ m	iː n f ɪ m ʊ m
p r ɔ s t ɪ t ʊ ɪ r ɛ	p r oː s t ɪ t ʊ ɛ r ɛ
a b j ɛ k t aː r ɛ	a b ɪ k ɛ r ɛ
s aː t ɪ s f aː k t j oː n ɛ m	s a t ɪ s f a k t j oː n ɛ m
aʊ r a m	aʊ r a m
ɛ k s p ɛ k t aː t j ɔ n ɛ	ɛ k sː p ɛ k t aː t j oː n ɛ m
s p aː r g ɛ r ɛ	s p a r g ɛ r ɛ
n ʊ t aː r ɛ	n uː t aː r ɛ
l uː k r ʊ m	l ʊ k r ʊ m
t r a d ɪ t oː r ɛ	t r aː d ɪ t oː r ɛ m
k aː t aː r ɛ ɛ	k ɔ a k t aː r ɛ
s k aː l p ɛ lː ʊ m	s k a l p ɛ lː ʊ m
p eː r a m	p eː r a m
a ŋ g ʊ s t aː r ɛ	a ŋ g ʊ s t aː r ɛ
d ɛ k ɪ m ʊ m	d ɛ k ɪ m ʊ m
a r m aː m ɪ n t ʊ m	a r m aː m ɛ n t ʊ m
k ʊ rː ɪ k ʊ l ʊ m	k ʊ rː ɪ k ʊ l ʊ m
