r ɛ s p ɔ n s ʊ m	r ɛ s p oː n s ʊ m
s ɛ s ʊ m	s ɛ sː ʊ m
p r ɔ t ɛ r w ʊ m	p r ɔ t ɛ r w ʊ m
a k k ɛ p t aː r ɛ	a kː ɪ p ɛ r ɛ
aː b r ɔ g aː r ɛ	a b r ɔ g aː r ɛ
k ɔ m ʊ n j oː n ɛ m	k ɔ mː uː n iː r ɛ
d ɛ g uː s t aː r ɛ	d eː g ʊ s t aː r ɛ
d ɪ s k r ɛ p aː r ɛ	d ɪ s k r ɛ p aː r ɛ
p ɛ r d r ɪ k	p ɛ r d iː k ɛ m
d ɪ s ɛ r t ʊ m	d ɪ s ɛ r t ʊ m
r a n k oː r ɛ	r a ŋ k oː r ɛ m
p ɔ r n ɔ g r a f j a	p ɔ r n ɔ g r a pʰ j a m
k a n d ɛ l aː b r ʊ m	k a n d eː l aː b r ʊ m
f r a ŋ g ɛ r ɛ	f r a ŋ g ɛ r ɛ
p r ɛ j uː d ɪ k j ʊ m	p r aɪ j uː d ɪ k j ʊ m
s p ɛ sː ʊ m	s p ɪ sː ʊ m
aː b r ɛ ɔ g a t oː n ɛ m	a b r ɔ g aː t j oː n ɛ m
s ɛ s kʷ ɪ p ɛ d aː l ɛ	s eː s kʷ ɪ p ɛ d aː l ɛ m
ɪ ŋ n ɔ m ɪ n j a m	ɪ ŋ n oː m ɪ n j a m
r ɛ p ʊ t aː r ɛ	r ɛ p ʊ t aː r ɛ
p ɛ r t ɪ k a m	p ɛ r t ɪ k a m
d ɛ n ɔ m ɪ n a t j oː n ɛ m	d eː n oː m ɪ n aː t j oː n ɛ m
d ɔ r m ɪ t aː r ɛ	d ɔ r m iː t aː r ɛ
k a s t r aː t ʊ m	k a s t r aː t ʊ m
a f j aː n t aː r ɛ	a fː ɪ d ɛ n t j aː r ɛ
ɪ n k a r n a t j oː n ɛ m	ɪ ŋ k a r n aː t j oː n ɛ m
w ɪ k ɪ n a m	w iː k iː n a m
p uː m aː r ɛ	p ʊ t eː r ɛ
ɪ n k ʊ rː ɛ r ɛ	ɪ ŋ k ʊ rː ɛ r ɛ
ɪ n k ɔ l a	ɪ ŋ k ɔ l a m
k ɔ rː ɛ k t oː r ɛ	k ɔ rː ɛ k t oː r ɛ m
a n ɛ t ʊ m	a n eː tʰ ʊ m
aː m ɛ n t ɛ	aː m ɛ n t ɛ m
w ɔ r a m r ɛ	w ɔ r aː r ɛ
f aː r ɛ t r a m	pʰ a r ɛ t r a m
k ʊ k ʊ m ɛ r ʊ m	k ʊ k ʊ m ɛ r ɛ m
r ɛ s t aː r ɛ	r ɛ s t aː r ɛ
r ɛ sː ɛ n a m r ɛ	r ɛ s ɪ ŋ n aː r ɛ
g ʊ s t a t j oː n ɛ m	g ʊ s t aː t j oː n ɛ m
g r a k ʊ a m	g r aː k ʊ l a m
s k ɔ r t a m	s k ɔ r t ɛ a m
s a l uː t aː r ɛ	s a l uː t aː r ɛ m
t ɔ r t oː n ɛ m	t ɔ r t j oː n ɛ m
f ɛ ʊ d ʊ m	f ɛu d ʊ m
m a t ʊ r aː r ɛ	m aː t uː r aː r ɛ
n ɛ p ɛ t ɛ m a m	n ɛ p ɛ t a m
ʊ m fː ɛ r t ɔ r j ʊ m	ɔ fː ɛ r t oː r j ʊ m
aː t ɛ s t a m r ɛ	a tː ɛ s t aː r iː
l a k t ɪ k ɪ n j ʊ m	l a k t ɪ k iː n j ʊ m
r ʊ g ʊ m s ʊ m	r uː g oː s ʊ m
k ɔ n s ɪ l a m r ɛ	k ɔ ŋ k ɪ l j aː r ɛ
k ɔ n s ʊ l t a t j oː n ɛ m	k oː n s ʊ l t aː t j oː n ɛ m
ɪ n d ɪ s k r ɛ t j oː n ɛ m	ɪ n d ɪ s k r eː t j oː n ɛ m
m ɛ n d aː k ɛ m	m ɛ n d aː k ɛ m
r oː d r ɛ ɪ k ɔ n	r ɪ d ɪ k a m
p ɔ p ɛ r t aː t	p aʊ p ɛ r t aː t ɛ m
d ɛ b ɛ lː aː r ɛ	d eː b ɛ lː aː r ɛ
a g r ɛ s t ɛ m	a g r ɛ s t ɛ m
m ɛ t ɪ t a b ʊ n d ʊ m	m ɛ d ɪ t aː b ʊ n d ʊ m
w ɛ n t r ɛ m	w ɛ n t r ɛ m
r aʊ k ʊ m	r aʊ k ʊ m
f ɔ r m ɛ m	f oː r m ɛ m
a ɪ k j aː k ʊ m	aɪ g y p t j a k ʊ m
ɛ t ɪ f ɪ k a t oː n ɛ m	aɪ d ɪ f ɪ k aː t j oː n ɛ m
s aː l s a	s a l s a m
k a p ɪ t a t j oː n ɛ m	k a p ɪ t aː t j oː n ɛ m
r aː b ʊ l a	r a b ʊ l a m
w ɪ n k ʊ l aː r ɛ	w ɪ ŋ k ʊ l aː r ɛ
d ɪ l ɛ kʷ aː r ɛ	d eː l ɪ kʷ aː r ɛ
t aː m ɪ s ʊ m	t a m ɪ s j ʊ m
ʊ m b sː ɛ kʷ j ʊ m	ɔ b s ɛ kʷ j ʊ m
b a p t ɪ s t aː	b a p t ɪ s t a m
k j ʊ n kʷ ɛ m k	kʷ ɛ m k ʊ m kʷ ɛ
m a mː ɛ lː a m	m a m ɪ lː a m
r uː g ɪ r ɛ	r uː g iː r ɛ
ɛ k s ɔ r t a t j oː n ɛ m	ɛ k s h ɔ r t aː t j oː n ɛ m
p r ɛ s aː r ɛ	p r ɛ t j aː r ɛ
f ʊ n d a m m ɛ n t ʊ m	f ʊ n d aː m ɛ n t ʊ m
ɔ kː ʊ l t aː r ɛ	ɔ kː ʊ l t aː r ɛ
r ɛ k ʊ s a t j oː n ɛ m	r ɛ k uː s aː t j oː n ɛ m
p iː nː aː k ʊ l ʊ m	p ɪ nː aː k ʊ l ʊ m
aː pː ɔ r t a m r ɛ	a pː ɔ r t aː r ɛ
ɛ k s t r ɛ ʊ t ɪ r ɛ	ɛ k s t r uː d ɛ r ɛ
ɪ ŋ n ɛ ʊ m	ɪ ŋ n ɛu m
m ʊ n ɪ f ɪ k ʊ m	m uː n ɪ f ɪ k ʊ m
k ʊ m n d ʊ m n aː r ɛ	k ɔ n d oː n aː r ɛ
m ʊ l k ɛ r ɛ	m ʊ l k eː r ɛ
k a l w ʊ m	k a l w ʊ m
l ɛ g ɪ	l eː g ɛ m
ɪ t ɛ n t ɪ t aː d ɛ m	iː d ɛ n t ɪ t aː t ɛ m
p r ɔ d ɪ g j ʊ m	p r oː d ɪ g j ʊ m
ɛ s t ʊ m	ɪ s t ʊ m
f ɔ m ɛ n t ʊ m	f oː m ɛ n t ʊ m
k aː r a m	k a r a m
w ɪ k ʊ m	w iː k ʊ m
ɛ l ɛ n k ʊ m	ɛ l ɛ ŋ kʰ ʊ m
l aː r t ʊ m	l a r d ʊ m
a kː uː s aː r ɛ	a kː uː s aː r ɛ
s t r aː d a m	s t r aː t a m
a n t ɪ k ɪ p a m r ɛ	a n t ɪ k ɪ p aː r ɛ
f ɔ l oː s ʊ m	f ɔ l j oː s ʊ m
g r a l ʊ m	g r aː k ʊ l ʊ m
ɛ l ɛ m ɔ s ɪ n a m	ɛ l ɛ eː m ɔ s y n a m
p ɛ lː ɪ k a n ʊ m	p ɛ l ɛ k aː n ʊ m
a b s t ɛ m j ʊ m	a b s t eː m j ʊ m
t r ɛ ɪ t ʊ r a	t r iː t uː r a m
ɪ n ʊ n d a t oː n ɛ m	ɪ n ʊ n d aː t j oː n ɛ m
n ɪ w ɛ lː ʊ m	l iː b ɛ lː a m
a nː ʊ ɪ r ɛ	a d n ʊ ɛ r ɛ
s k r ʊ t ɪ n j ʊ m	s k r uː t ɪ n j ʊ m
k f ɪ l ʊ l oː	f iː l ɪ ɔ l ʊ m
ɛ k s t ɛ r m ɪ n a t j oː n ɛ m	ɛ k s t ɛ r m ɪ n aː t j oː n ɛ m
n ʊ t r ɪ k ɛ	n uː t r iː k ɛ m
d ɪ k aː k ɛ	d ɪ k aː k ɛ m
a g ɪ t aː r ɛ	a g ɪ t aː r ɛ
d uː k ɪ r ɛ	d uː k ɛ r ɛ
s a p oː r ɛ	s a p oː r ɛ m
n ʊ t ʊ m	n uː t ʊ m
p aː l ʊ d aː m ɛ n t ʊ m	p a l uː d aː m ɛ n t ʊ m
r ɛ k ʊ r s j oː n ɛ m	r ɛ k ʊ r s j oː n ɛ m
t r ɪ g ɛ s ɪ m ʊ m	t r iː g eː s ɪ m ʊ m
uː m ɪ d ʊ m	h uː m ɪ d ʊ m
s ɔ n a m t oː r ɛ	s ɔ m n j aː t oː r ɛ m
ɪ t ɛ r aː r ɛ	ɪ t ɛ r aː r ɛ
l aː r g ʊ m	l a r g ʊ m
t aː sː ʊ m n	t a k s ʊ m
t a m k ɛ r ɛ	t a k eː r ɛ
aː k ʊ m ɛ	a k uː m ɛ n
k ʊ l uː m ɛ lː a m	k ɔ l ʊ m ɛ lː a m
r ɛ w ɛ r b ɛ r aː r ɛ	r ɛ w ɛ r b ɛ r aː r ɛ
s ʊ b s t a n t j a m	s ʊ b s t a n t j a m
f ɪ k ʊ m	f iː k ʊ m
p ɛ r m a n t ɛ r ɛ	p ɛ r m a n eː r ɛ
g r aː m a m	g r aː m ɛ n
l ɪ t aː r ɛ	l ɪ t aː r ɛ
k ʊ l ɛ w r a m	k ɔ l ʊ b r a m
r ʊ ɪ b j a m	r ʊ b j a m
w ɪ d ʊ m	w ɔ k ɪ t ʊ m
k a p aː k ɛ	k a p aː k ɛ m
k r ʊ k ɪ f ɛ r ʊ m	k r ʊ k ɪ f ɛ r ʊ m
k aː s t r ʊ	k a s t r ʊ m
w ʊ l t ʊ m	w ʊ l t ʊ m
s ɛ m g aː r ɛ	s ɛ k aː r ɛ
k a w ʊ m	k a w ʊ m
m aː n s j oː n ɛ m	m aː n s j oː n ɛ m
r aː p ʊ m	r aː p ʊ m
n ʊ m ɛ m r ʊ m	n ʊ m ɛ r ʊ m
ɔ l oː r ɛ	ɔ l oː r ɛ m
p r ɛ ɛ m g oː n ɛ m	p r aɪ k oː n ɛ m
ɪ m p uː l s ʊ m	ɪ m p ʊ l s ʊ m
ɪ n t ɛ rː ʊ p t j oː n ɛ m	ɪ n t ɛ rː ʊ p t j oː n ɛ m
ɪ m p ɛ m t r aː r ɛ	ɪ m p ɛ t r aː r ɛ
t r ʊ k ɛ	t r ʊ k ɛ m
p ɛ r k a m	p ɛ r k a m
t ɛ r t j aː r ɛ	t ɛ r t j aː r ɛ
f aː m ʊ l ʊ m	f a m ʊ l ʊ m
k a n ɪ n ʊ m	k a n iː n ʊ m
m ɪ n ɔ r aː r ɛ	m ɪ n oː r aː r ɛ
ʊ s ɪ n ɔ l ʊ m	l ʊ s k ɪ n j a m
t ʊ s oː n ɛ m	t oː n s j oː n ɛ m
k a p ɛ lː ʊ m	k a p ɪ lː ʊ m
ɪ k ɪ d aː t ɛ m	a k ɪ d ɪ t aː t ɛ m
w ɛ r t ɪ g ɪ n oː s ʊ m	w ɛ r t iː g ɪ n oː s ʊ m
ɛ r m aː n d aː d ɛ m	g ɛ r m aː n ɪ t aː t ɛ m
f a s ɪ n ʊ m	f a s k ɪ n ʊ m
k ɛ m r t aː r ɛ	k ɛ r t aː r ɛ
b ɔ t ʊ l ɪ n ʊ m	b ɔ t ʊ l ʊ m
aː b n ɔ r m ɛ	a b n oː r m ɛ m
j uː g ɛ r ʊ m	j uː g ɛ r ʊ m
p r ɛ f ɛ r ɪ r ɛ	p r aɪ f ɛ rː ɛ
k a p ɪ t ʊ m	k a p ɪ t ʊ l ʊ m
r ɛ l ʊ k ɛ r ɛ	r ɛ l uː k eː r ɛ
d uː r aː r ɛ	d uː r aː r ɛ
w a k ɪ ʊ m	w a k iː w ʊ m
s k r ɪ n ʊ m	s k r iː n j ʊ m
j aː s p ɪ d ɛ m	j a s p ɪ d ɛ m
p ʊ b ɛ m	p uː b ɛ r ɛ m
a w ɛ m l ʊ n a m	a b ɛ lː a n a m
r ɛ f l ʊ ɪ r ɛ	r ɛ f l ʊ ɛ r ɛ
k ɔ n s ɛ r w aː r ɛ	k oː n s ɛ r w aː r ɛ
t ɔ m ʊ m	t ɔ m ʊ m
n ɛ g ɔ t j ʊ m	n ɛ g oː t j ʊ m
s a p oː n ɛ	s aː p oː n ɛ m
d ɪ fː ʊ n d ɛ r ɛ	d ɪ fː ʊ n d ɛ r ɛ
ɛ k s aː l t a m r ɛ	ɛ k s a l t aː r ɛ
b a s ɪ l ɪ s k ʊ m	b a s ɪ l ɪ s k ʊ m
aː n oː t ɪ n ʊ m	a nː oː t ɪ n ʊ m
ɪ w ʊ m	iː w ʊ m
k a p r ɪ n ʊ m	k a p r iː n ʊ m
d ɛ m w ɔ l w ɛ r ɛ	d eː w ɔ l w ɛ r ɛ
s ɔ l ɪ d ʊ m	s ɔ l ɪ d ʊ m
s ʊ w ɛ n ɪ r ɛ	s ʊ b w ɛ n iː r ɛ
l ɪ r ɪ k ʊ m	l y r ɪ k ʊ m
ɛ kʷ ɪ w ʊ m k aː r ɛ	aɪ kʷ ɪ w ɔ k aː r ɛ
k r a m t ɪ k ʊ l a m	k r aː t ɪ k ʊ l a m
n a m n ʊ m	n aː n ʊ m
t ɛ n ɛ b r ɛ s	t ɛ n ɛ b r aː s
ɔ r ɪ zː oː n t ɛ m	h ɔ r ɪ zː ɔ n t a
aː ŋ ɛ lː ɔ	a ŋ n ɛ lː ʊ m
ɪ n ʊ l t ʊ m	ɪ n ʊ l t ʊ m
p ʊ t ʊ m	p ʊ t ʊ m
ɪ m p r ɛ ɔ b aː r ɛ	ɪ m p r ɔ b aː r ɛ
m ɔ l aː r ɛ	m ɔ l aː r ɛ m
l uː k s ʊ m	l uː k s ʊ m
n ɪ w ɛ ʊ m	n ɪ w ɛu m
p a b ɔ r	p a w oː r ɛ m
t eːa n ɛ r n ʊ m	t ɛ n ɛ r ʊ m
t ɛ k s t ɪ l	t ɛ k s t ɪ l ɛ
a sː ɪ ŋ n aː r ɛ	a sː ɪ ŋ n aː r ɛ
k ɔ n s ɔ l aː r ɛ	k oː n s oː l aː r iː
s aː n aː t j ʊ m n ɛ m	s aː n aː t j oː n ɛ m
l aː k r ɪ m a m	l a k r ɪ m a m
m ʊ n t oː s ʊ m	m ɔ n t ʊ oː s ʊ m
m aː l ɛ d ɪ k t j oː n ɛ m	m a l ɛ d ɪ k t j oː n ɛ m
l ɛ t ɪ t j aː m	l aɪ t ɪ t j a m
p ʊ ɛ r ɪ l ɛ	p ʊ ɛ r iː l ɛ m
l uː k b r ɛ ɛ k aː r	l uː k ʊ b r aː r ɛ
r ɛ s t ɪ t ʊ ɛ r ɛ	r ɛ s t ɪ t ʊ ɛ r ɛ
d ɛ s p l eː g aː r ɛ	d ɪ s p l ɪ k aː r ɛ
aː k t ʊ m	aː k t ʊ m
d ɛ s ɔ l a t j oː n ɛ m	d eː s oː l aː t j oː n ɛ m
w ɪ n d ɪ k t a m	w ɪ n d ɪ k t a m
s ɛ pː ʊ lː aː r ɛ	s ɛ p ɛ l iː r ɛ
l ɪ ŋ g uː l a m	l ɪ ŋ g ʊ l a m
t ɪ t ɪ s ʊ m	k y t ɪ s ʊ m
k ɔ m p l a m k ɛ r ɛ	k ɔ m p l a k eː r ɛ
k ɪ r k ʊ n s k r ɪ w ɛ r ɛ	k ɪ r k ʊ m s k r iː b ɛ r ɛ
s ɔ m nː ɔ l ɛ n t ʊ m	s ɔ m n ɔ l ɛ n t ʊ m
p ɔ n t ɪ f ɪ k aː t ʊ m	p ɔ n t ɪ f ɪ k aː t ʊ m
w ɛ r m ɛ m	w ɛ r m ɛ m
g ʊ m ɛ n t ʊ m	j uː m ɛ n t ʊ m
p ɔ l ʊ m	p ɔ l ʊ m
m ɛ s uː r a m	m eː n s uː r a m
ɔ t ɛ aː r j ʊ m	ɔ sː w aː r j ʊ m
s ɛ r ʊ m m	s ɛ r ʊ m
ɪ n w ɛ s t ɪ r ɛ	ɪ n w ɛ s t iː r ɛ
k ɛ sː aː r ɛ	k ɛ sː aː r ɛ
p ɛ k t ɪ n aː r ɛ	p ɛ k t ɪ n aː r ɛ
s aː k r ʊ m	s a k r ʊ m
p l aː n aː r ɛ	p l aː n aː r j ʊ m
k ɔ n f ɛ r iː r ɛ	k oː n f ɛ rː ɛ
aː s t r ɪ ŋ g ɛ r ɛ	a s t r ɪ ŋ g ɛ r ɛ
a sː ɪ s t ɛ r ɛ	a sː ɪ s t ɛ r ɛ
b ɛ r z a m	w ɪ r ɪ d ɛ m
ɛ k s k ɔ g ɪ t aː t j ʊ m n ɛ m	ɛ k s k oː g ɪ t aː t j oː n ɛ m
p r ɛ s t aː r ɛ	p r aɪ s t aː r ɛ
p r ɛ s ɛ p ɛ m	p r aɪ s aɪ p ɛ
f ɛ m t ɛ r ɛ	f eː t eː r ɛ
b ʊ k ɪ n aː	b uː k ɪ n a m
m a t r ɪ m oː n j ʊ m	m aː t r ɪ m oː n j ʊ m
j uː d ɪ t j aː r j ʊ m	j uː d ɪ k j aː r j ʊ m
p ɪ g r m ɪ t j a m	p ɪ g r ɪ t j a m
w ɛ ɛ m m ɛ n t ɛ m	w ɛ h ɛ m ɛ n t ɛ m
aʊ d aː k ɛ	aʊ d aː k ɛ m
p r ɛ w j ʊ m	p r aɪ w j ʊ m
s k ɔ l aː s t ɪ k ʊ m	s kʰ ɔ l a s t ɪ k ʊ m
a s p ɛ r g ɛ r ɛ	a s p ɛ r g ɛ r ɛ
t ɛ t r ʊ m	t aɪ t r ʊ m
d ʊ l t ɪ s ɔ n ʊ m	d ʊ l k ɪ s ɔ n ʊ m
p a k ɪ f ɪ k ʊ m	p aː k ɪ f ɪ k ʊ m
g ɛ l ʊ m	g ɛ l uː
l a b oː r ɛ m	l a b oː r ɛ m
p r ɛ d ɔ m ɪ n aː r ɛ	p r aɪ d ɔ m ɪ n aː r iː
p r ɛ s ɛ n t ɪ r	p r aɪ s ɛ n t iː r ɛ
w ɔ r t ɪ k k ɛ m	w ɔ r t ɪ k ɛ m
m aː g ʊ m	m a g ʊ m
p r ɛ k l aː r ʊ m	p r aɪ k l aː r ʊ m
k ɔ t ɔ r n ɪ k ɛ	k oː t ʊ r n iː k ɛ m
a fː ɛ k t j oː n ɛ m	a fː ɛ k t j oː n ɛ m
s ɪ r p ʊ m	s k ɪ r p ʊ m
k r ɪ m ɪ n oː s ʊ m	k r iː m ɪ n oː s ʊ m
a d ɪ k t ʊ m	a dː ɪ k t ʊ m
n a w ɪ g aː r ɛ	n aː w ɪ g aː r ɛ
aː s t r ʊ m	a s t r ʊ m
p r ɔ w ɔ k aː r ɛ	p r oː w ɔ k aː r ɛ
l a b ʊ r aː r ɛ	l a b oː r aː r ɛ
r ɛ t ɪ k ɛ r ɛ	r ɛ t ɪ k eː r ɛ
ɪ n t r ɪ n t ɛ k ʊ m	ɪ n t r iː n s ɛ k ʊ m
p ɔ n d ɛ r aː t j ʊ m n ɛ m	p ɔ n d ɛ r aː t j oː n ɛ m
t ʊ m r t ʊ m r ɛ	t ɔ r t oː r ɛ m
p r ɛ ɛ m w ɛ r ɛ	p r aɪ w ɪ d eː r ɛ
k ɔ ŋ j ʊ g a t j oː n ɛ m	k ɔ n j ʊ g aː t j oː n ɛ m
k ɔ n t ɛ n t ʊ m	k ɔ n t ɛ n t ʊ m
t ɔ r p oː r ɛ	t ɔ r p oː r ɛ m
a s t ʊ t j a m	a s t uː t j a m
g ɛ n t ɪ l ɪ t aː t ɛ m	g ɛ n t iː l ɪ t aː t ɛ m
aʊ g uː r aː r ɛ	aʊ g ʊ r aː r ɛ
ɪ t aː t ɛ m	ɪ t aː t ɛ m
s uː fː ɪ k j ɛ n t j a m	s ʊ fː ɪ k ɪ ɛ n t j a m
t ɛ d j oː s ʊ m	t aɪ d j oː s ʊ m
a lː ʊ ŋ g aː r ɛ	eː l ɔ ŋ g aː r ɛ
k ɛ r t aː m ɛ	k ɛ r t aː m ɛ n
k r ʊ s t oː s ʊ m	k r ʊ s t oː s ʊ m
p r ʊ m l ɔ kʷ j ʊ m	p r oː l ɔ kʷ j ʊ m
m aː s a m	m a sː a m
m a ŋ n ɛ s j ʊ m	m a ŋ n eː s j ʊ m
f uː l g ɪ r ɛ	f ʊ l g eː r ɛ
m ɛ r ɛ m t r ɪ k ɛ	m ɛ r ɛ t r iː k ɛ m
s ʊ pː l ɪ r ɛ	s ʊ pː l eː r ɛ
s ʊ n ɪ t ʊ m	s ɔ n ɪ t ʊ m
r ʊ t ɪ l aː r ɛ	r ʊ t ɪ l aː r ɛ
p aː l j uː r	p a l ɪ uː r ʊ m
p ɔ lː aː r ʊ m	p ʊ lː aː r j ʊ m
ɔ b l a t j oː n ɛ m	ɔ b l aː t j oː n ɛ m
s aː n t ʊ m r j ɛ t a m	s a t ʊ r eː j a m
m oː l ɪ n ɛ m ɛ r ʊ m	m ɔ l iː n aː r j ʊ m
ʊ r ʊ m	uː r ʊ m
t ɛ n ɛ b r ʊ m s ʊ m	t ɛ n ɛ b r oː s ʊ m
a nː ɪ k ɪ l aː r ɛ	a nː ɪ h ɪ l aː r ɛ
d ɪ fː ɛ r ɪ r ɛ	d ɪ fː ɛ rː ɛ
aː n ɪ s	a n iː s ʊ m
w ɛ k ɪ	w ɪ k ɛ m
f a m oː s ʊ m	f aː m oː s ʊ m
a m b aː g ɛ m s	a m b aː g ɛ m
f a rː aː g ɪ n ɛ	f a rː aː g ɪ n ɛ m
k uː l t ʊ m	k ʊ l t ʊ m
a s aː r ɛ	a sː aː r ɛ
w ɛ m r n aː l ɛ	w ɛ r n aː l ɛ m
aː k ʊ m	a k ʊ m
b aː s j ʊ m	b aː s j ʊ m
t aː l aː m ʊ m	tʰ a l a m ʊ m
g aː l ɛ n a m	g a l eː n a m
g r a n aː r ʊ m	g r aː n aː r j ʊ m
r ɪ m a n ɛ r ɛ	r ɛ m a n eː r ɛ
ʊ m ɪ l a t j oː n ɛ m	h ʊ m ɪ l j aː t j oː n ɛ m
ɪ m p l ɪ k aː r ɛ	ɪ m p l ɪ k aː r ɛ
k ʊ p ɛ r t ʊ r a m	k ɔː p ɛ r t uː r a m
k ɪ p r ɛ sː ʊ	k ʊ p r ɛ sː ʊ m
aː nː aː l ɪ	a nː aː l ɛ m
ɔ rː ɪ f ɪ k ʊ m	h ɔ rː ɪ f ɪ k ʊ m
d ɔ r aː r ɛ	d ɛ aʊ r aː r ɛ
b aː s t ɛ r n a m	b a s t ɛ r n a m
s p uː m aː r ɛ	s p uː m aː r ɛ
k ʊ rː ɛ aː	k ɔ rː ɪ g j a m
w ɪ s ɪ t aː t j ʊ m n ɛ	w iː s ɪ t aː t j oː n ɛ m
r ʊ s t ɪ k aː n ʊ m	r uː s t ɪ k aː n ʊ m
s p ɛ k ʊ ʊ m	s p ɛ k l ʊ m
k aː l k ɔ l a t oː n ɛ m	k a l k ʊ l aː t j oː n ɛ m
ʊ ŋ g ɛ r ɛ	ʊ ŋ g ɛ r ɛ
t ʊ g ʊ r j ʊ m	t ʊ g ʊ r j ʊ m
s ɔ l aː r ɪ ʊ m	s oː l aː r j ʊ m
ɛ k s t ɪ ŋ gʷ ɛ r ɛ	ɛ k s t ɪ ŋ gʷ ɛ r ɛ
s ɪ m ɪ l ɛ	s ɪ m ɪ l ɛ m
k ɔ j a m t ʊ m	k ɔ mː ɛ aː t ʊ m
ɛ l ɛ k t j ʊ m n ɛ m	eː l eː k t j oː n ɛ m
g ɛ t ʊ m	j a k t ʊ m
n ɛ f aː s t ʊ m	n ɛ f aː s t ʊ m
p aː l a m	p aː l a m
m ɔ d ɛ r aː r ɛ	m ɔ d ɛ r aː r iː
t w ʊ m	t ʊː m
k ɔ lː ɛ k t j oː n ɛ m	k ɔ lː eː k t j oː n ɛ m
d ɛ m g ɔ l aː r ɛ	d eː k ɔ lː aː r ɛ
l a ŋ gʷ ɪ d ʊ m	l a ŋ gʷ ɪ d ʊ m
r ɛ n ʊ ɪ r ɛ	r ɛ n ʊ ɛ r ɛ
ɪ b r ɪ d ʊ m	h y b r ɪ d a m
ɛ s ɛ r k ɪ t ʊ m	ɛ k s ɛ r k ɪ t ʊ m
f ɛ k ʊ l ɛ n t ʊ m	f aɪ k ʊ l ɛ n t ʊ m
l ɪ b ɛ l ʊ m	l ɪ b ɛ lː ʊ m
f l ɛ k sː ɪ b ɪ l ɪ t aː t ɛ m	f l ɛ k s ɪ b ɪ l ɪ t aː t ɛ m
s ɛ n ɪ k ʊ m	s k eː n ɪ k ʊ m
ɪ n ʊ m a n ɪ t aː t ɛ m	ɪ n h uː m aː n ɪ t aː t ɛ m
l ʊ t ʊ m	l ʊ t ʊ m
t r ɛ m ʊ l ʊ m	t r ɛ m ʊ l ʊ m
w ɛ t r ɪ k ɛ	w iː t ɪ k ɛ m
ɪ sː ɪ m ʊ m	ɪ sː ɪ m ʊ m
l ɪ k t oː r ɛ	l iː k t oː r ɛ m
p ɔ n d ɛ r aː r ɛ	p ɔ n d ɛ r aː r ɛ
d ɔ t aː t j ʊ m n ɛ m	d oː t aː t j oː n ɛ m
t r a n s m ɪ g r a m r ɛ	t r aː n s m ɪ g r aː r ɛ
s a n t ʊ m	s aː ŋ k t ʊ m
p aː r s ɪ m ɔ n j a m	p a r k ɪ m oː n j a m
a m p ɔ lː a m	a m p ʊ lː a m
k ɔ m p r ɔ m ɛ t ɛ r ɛ	k ɔ m p r oː m ɪ tː ɛ r ɛ
f ʊ s t ɪ g aː r ɛ	f uː s t iː g aː r ɛ
r ɪ k sː a m	r ɪ k s a m
ɔ d oː r ɛ	ɔ d oː r ɛ m
r ɛ g ʊ l aː r ɛ	r eː g ʊ l aː r ɛ
n a t j oː n ɛ m	n aː t j oː n ɛ m
a t ɛ t aː r ɛ	oː s k ɪ t aː r ɛ
p ʊ l k r ɛ ɪ t ʊ d ɛ m	p ʊ l kʰ r ɪ t uː d ɪ n ɛ m
n ʊ m t ɔ r j ʊ m	n oː t oː r j ʊ m
a d ɔ l ɛ s k ɛ n t j a m	a d ʊ l eː s k ɛ n t j a m
k a p ɪ t ʊ l a t j oː n ɛ m	k a p ɪ t ʊ l aː t j oː n ɛ m
m uː g ɪ r ɛ	m uː g iː r ɛ
ɔ b t ɛ n ɛ r ɛ	ɔ b t ɪ n eː r ɛ
k a n d ɪ d ʊ m	k a n d ɪ d ʊ m
a pː r ɛ h ɛ n s j oː n ɛ m	a pː r ɛ h ɛ n s j oː n ɛ m
ɪ m p aː w ɪ d ʊ m	ɪ m p a w ɪ d ʊ m
f l oː r iː r ɛ	f l oː r eː r ɛ
d j aː b ɔ l ɪ k ʊ m	d j a b ɔ l ɪ k ʊ m
s t r ɪ g a m	s t r iː g a m
ɛ g s ɛ r k ɛ r ɛ	ɛ k s ɛ r k eː r ɛ
a kː r ɛ m s k ɛ r ɛ	a kː r eː s k ɛ r ɛ
p aː r t ʊ m	p a r t ʊ m
fː uː m iː k aː r ɛ	f uː m ɪ g aː r ɛ
ɔ l ɪ g aː r k ɪ k ʊ m	ɔ l ɪ g a r kʰ ɪ k ʊ m
ɪ n k ɔ r w aː r ɛ	ɪ ŋ k ʊ r w aː r ɛ
s eː n ʊ m	s ɪ n ʊ m
k k ɛ	kʷ ɛ m
d ɛ s uː l t oː r j ʊ m	d eː s ʊ l t oː r j ʊ m
t ʊ sː ɛ r ɛ	t ʊ sː iː r ɛ
f ʊ l g ʊ m r ɛ	f ʊ l g ʊ r
ɛ k s t ɛ m r j oː r ɛ	ɛ k s t ɛ r j oː r ɛ m
k aʊ t ɛ l a m	k aʊ t eː l a m
w aː lː ɛ t ʊ m	w a lː ɛ tː ʊ m
m ɔ r a	m ʊ r j a m
ɪ n s ɪ ŋ n ɛ m	iː n s ɪ ŋ n ɛ m
r ɛ f l oː r ɪ r ɛ	r ɛ f l oː r eː r ɛ
k ɛ sː a t j oː n ɛ m	k ɛ sː aː t j oː n ɛ m
k ɔ k s aː l ɛ	k ɔ k s aː l ɛ m
k aː s ʊ m	k aː s ʊ m
k a n ɔ r ʊ m	k a n oː r ʊ m
f l uː w m	f l ʊ w j ʊ m
d ɛ f ɛ n s oː r ɛ	d eː f eː n s oː r ɛ m
s ɔ l ɪ t uː w r	s oː l ɪ t uː d ɪ n ɛ m
