k aː pː l ʊ m	k a p ʊ l ʊ m
s t ɪ r p ɛ m	s t ɪ r p ɛ m
k ɔ m p ɔ r t aː r ɛ	k ɔ m p ɔ r t aː r ɛ
k ɔ ŋ g uː r aː r ɛ	k ɔ n ɪ uː r aː r ɛ
uː b ɪ k aː t j oː n ɛ m	ʊ b ɪ k aː t j oː n ɛ m
k ɪ p a m	k aɪ p a m
a d ɪ k t ʊ m	a dː ɪ k t ʊ m
a m ɛ n ɪ t aː t ɛ m	a m ɔ ɪ n ɪ t aː t ɛ m
r ɛ l aː k s aː r ɛ	r ɛ l a k s aː r ɛ
g ɛ r m ɛ m n	g ɛ r m ɛ n
t ɔ r t ɪ l ɛ	t ɔ r t ɪ l ɛ m
k ɔ n s a ŋ gʷ ɪ n ɪ t aː t ɛ	k oː n s a ŋ gʷ ɪ n ɪ t aː t ɛ m
a kː ɔ m ɔ d aː t j oː n ɛ m	a kː ɔ mː ɔ d aː t j oː n ɛ m
ʊ n t ɔ ɛ s ʊ m	uː ŋ k t ʊ oː s ʊ m
ɪ m p aː w ɪ d ʊ m	ɪ m p a w ɪ d ʊ m
ɔ b j ɛ k t ɪ w ʊ m	ɔ b j ɛ k t iː w ʊ m
p aː r ʊ m	p a r ɛ m
iː t j a m	ɪ t j a m
m ɛ n t ʊ m n	m ɛ n t ʊ m
k ɔ r t ɛ m	k oː r t ɛ m
b aː r k a m	b a r k a m
g r a n d ɛ m	g r a n d ɛ m
p l aː t ɛ j a m	p l a t eːa m
r ʊ g ʊ m	r ɔ g ʊ m
t r a n s p oː r ɛ	t r aː n s p oː n ɛ r ɛ
ɛ m ɛ t ɛ r ɛ	eː m ɪ tː ɛ r ɛ
p ɛ d ɪ k ɛ lː ʊ m	p ɛ d iː k ɛ lː ʊ m
ʊ m l ʊ m	ʊ l ʊ m
s ɛ ŋ t ɪ r ɛ	s ɛ n t iː r ɛ
ɪ n k aː r n aː r ɛ	ɪ ŋ k a r n aː r ɛ
ɪ m p r ɛ m k aː r ɛ	ɪ m p r ɛ k aː r iː
k ɔ r w ɪ n ʊ m	k ɔ r w iː n ʊ m
k r ɛ t a m	k r eː t a m
n ɪ w ɛ lː oː	l iː b ɛ lː a m
s a m l k ɛ t ʊ m	s a l ɪ k eː t ʊ m
ɔ t r ɛ m	ʊ t r ʊ m
g ʊ w ɛ r n aː t ɔ r ɛ	g ʊ b ɛ r n aː t oː r ɛ m
d ɪ s t ɪ lː aː t j ʊ m n ɛ m	d ɪ s t ɪ lː a t j oː n ɛ m
p ʊ g ɪ l ɛ	p ʊ g ɪ l ɛ m
p ɛ r t ɪ k a m	p ɛ r t ɪ k a m
w ɪ d ʊ ɪ t aː	w ɪ d ʊ ɪ t aː t ɛ m
k ɛ r k ɪ n ɛ	k ɪ r k ɪ n ʊ m
ɛ g s ɛ m p l aː r	ɛ k s ɛ m p l a r
a m ɛ n t ʊ m	aː m ɛ n t ʊ m
ɪ n t ɛ rː ʊ m p ɛ r ɛ	ɪ n t ɛ rː ʊ m p ɛ r ɛ
n ʊ n t j ʊ m	n uː n t j ʊ m
l ɛ g a m j ɪ	l ɪ g aː m ɛ n
r ɛ k ɛ n s ɪ r ɛ	r ɛ k eː n s eː r ɛ
w aː n ɪ	w a nː ʊ m
g r aː w ɪ t aː t j oː n ɛ	g r a w ɪ t aː t j oː n ɛ m
ɪ n w ɛ n t oː r ɛ	ɪ n w ɛ n t oː r ɛ m
a b ɪ t ʊ aː l ɛ	h a b ɪ t w aː l ɛ m
k r j aː t uː r a m	k r ɛ aː t uː r a m
a g aː r ɪ k ʊ m	a g a r ɪ k ʊ m
r ɛ sː ɛ n a m r ɛ	r ɛ s ɪ ŋ n aː r ɛ
ɛ f ɛ k t ɪ w ʊ m	ɛ fː ɛ k t iː w ʊ m
d ɛ r aː t ʊ r a m	d iː r ɛ k t uː r a m
d ɛ m m oː n ɪ k ʊ m	d aɪ m ɔ n ɪ k ʊ m
p ʊ t aː r ɛ m	p ʊ t aː r ɛ
ɛ t ʊ m	ɛ tː ʊ m
p ɔ s aː r ɛ	p aʊ s aː r ɛ
ɛ k s aː l a m r ɛ	ɛ k s h aː l aː r ɛ
ɪ m b ʊ ɪ r ɛ	ɪ m b ʊ ɛ r ɛ
r ɛ l ɛ w aː r ɛ	r ɛ l ɛ w aː r ɛ
s a l t ʊ m	s a l t ʊ m
p r ɔ w ɔ k aː r ɛ	p r oː w ɔ k aː r ɛ
d ɪ s k ʊ r s ʊ m	d ɪ s k ʊ r s ʊ m
p aː t r j aː r k aː t ʊ m	p a t r j a r kʰ a t ʊ m
k ɔ r t ɛ m	k ɔ h ɔ r t ɛ m
m aː t r ɪ m oː n j ʊ m	m aː t r ɪ m oː n j ʊ m
f ɪ n kː aː r ɛ	f iː g ɛ r ɛ
g r aː n aː t ʊ m	g r aː n aː t ʊ m
t r aː k j ʊ m	tʰ r aː k j ʊ m
m ɪ n uː j j a m	m ɪ n uː t j a m
m aː t r ɛ ɪ t ɪ t j ʊ m	m aː t r ɪ k iː d j ʊ m
b ɛ n ɛ d ɪ k t j oː n ɛ m	b ɛ n ɛ d ɪ k t j oː n ɛ m
m ɛ d j aː l ɛ	m ɛ d j aː l ɛ m
m ɔ d ɛ r aː t oː r ɛ	m ɔ d ɛ r aː t oː r ɛ m
ɪ n s ɛ m n aː r ɛ	iː n s ɪ ŋ n aː r ɛ
f ɛ k ʊ n d ɔ	f eː k ʊ n d ʊ m
n ʊ k ɛ t ʊ m	n ʊ k eː t ʊ m
m aː t r ɪ k ʊ l a m	m aː t r iː k ʊ l a m
kʷ ɛ s t j ɔ n aː r j ʊ m	kʷ aɪ s t j oː n aː r j ʊ m
f ɛ mː ɪ n ɪ n ʊ m	f eː m ɪ n iː n ʊ m
r aː m ʊ m	r aː m ʊ m
a nː eː k aː r ɛ	n ɛ k aː r ɛ
b aː k t ɪ s m ʊ m	b a p t ɪ s m ʊ m
k ɔ n t ʊ m aː k ɛ	k ɔ n t ʊ m aː k ɛ m
ɪ n j ɛ k t j oː n ɛ m	ɪ n ɪ ɛ k t j oː n ɛ m
s p ʊ s aː r ɛ	s p oː n s aː r ɛ
p a m pː aː r ɛ	p a pː aː r ɛ
d ɪ s p aː r aː r ɛ	d ɪ s p a r aː r ɛ
l uː k s	l uː k ɛ m
a l aː k r ɪ t aː t ɛ m	a l a k r ɪ t aː t ɛ m
a nː ɛ k s ʊ m	a nː ɛ k s ʊ m
d ɛ p r ɛ k aː r ɛ	d eː p r ɛ k aː r iː
k ʊ w a m r ɛ	k ʊ b aː r ɛ
t ʊ r d ʊ m	t ʊ r d ʊ m
ɪ lː uː s j ʊ m n ɛ m	ɪ lː uː s j oː n ɛ m
r ɛ m ɛ m k ɛ r ɛ	r ɛ m ɪ s k eː r ɛ
ɛ fː l uː ɪ r ɛ	ɛ fː l ʊ ɛ r ɛ
d ɛ r ɪ s j ʊ m n ɛ m	d eː r iː s j oː n ɛ m
k ɔ n s ɔ r t ɛ m	k oː n s ɔ r t ɛ m
d ɛ s ɔ l aː t j oː n ɛ m	d eː s oː l aː t j oː n ɛ m
l ɪ b ɛ l ʊ m	l ɪ b ɛ lː ʊ m
l a ŋ gʷ ɪ d ʊ m	l a ŋ gʷ ɪ d ʊ m
f ɪ l ʊ	f l ʊ k t ʊ m
a lː oː k aː r ɛ	a lː ɔ k aː r ɛ
d ɛ s w j a m r ɛ	d eː w j aː r ɛ
l ʊ m k aː r ɛ	l ɔ k aː r ɛ
ʊ m ʊ s	h ʊ m ʊ m
n aː f t a m	n a pʰ tʰ a m
d ɛ s t ɪ t ʊ iː r ɛ	d eː s t ɪ t ʊ ɛ r ɛ
f uː l g ɪ r ɛ	f ʊ l g eː r ɛ
m ʊ r ɪ r ɛ	m ɔ r iː
p uː aː r ɛ	p ʊ t eː r ɛ
s ɔ l ɪ l ɔ kʷ j ʊ m	s oː l ɪ l ɔ kʷ j ʊ m
a p j aː r j ʊ m	a p j aː r j ʊ m
ɪ n k ɛ n d j ʊ m	ɪ ŋ k ɛ n d j ʊ m
k a m p ɛ s t r ɛ m	k a m p ɛ s t r ɛ m
d ʊ b l ʊ m	d ʊ p l ʊ m
p l ɪ n ɪ t aː	p l eː n ɪ t aː t ɛ m
k ʊ p ɪ d ɪ t aː	k ʊ p ɪ d ɪ t aː t ɛ m
a nː ʊ ɪ r ɛ	a d n ʊ ɛ r ɛ
k ʊ n a r ɛ	k ʊ n ɛ aː r ɛ
a pː aː r ɛ n t ɛ m	a pː a r ɛ n t ɛ m
ɔ b s ɛ r w aː r ɛ	ɔ b s ɛ r w aː r ɛ
s aː r g ʊ m	s a r g ʊ m
n aː t aː l ɪ t j ʊ m	n aː t aː l iː k j ʊ m
n uː t r ɪ k aː r ɛ	n uː t r iː k aː r ɛ
s ʊ b ʊ r b a m n ʊ m	s ʊ b ʊ r b aː n ʊ m
p uː b l ɪ k ʊ m	p uː b l ɪ k ʊ m
s t ɪ m ʊ l aː t j oː n ɛ m	s t ɪ m ʊ l aː t j oː n ɛ m
n eː k r ɛ t ɪ r	n ɪ g r eː s k ɛ r ɛ
m ʊ n ɔ m	m uː n ʊ s
k aː l aː m ɪ t oː s ʊ m	k a l a m ɪ t oː s ʊ m
a lː ʊ d ɪ r ɛ	a lː uː d ɛ r ɛ
k aː l k aː r ɛ ʊ m	k a l k aː r j ʊ m
ɪ n f l ɛ k sː j oː n ɛ m	iː n f l ɛ k t j oː n ɛ m
ɛ k s p uː r g aː t j oː n ɛ m	ɛ k s p ʊ r g aː t j oː n ɛ m
a b ɛ rː aː r ɛ	a b ɛ rː aː r ɛ
b ʊ r ʊ m	b uː t y r ʊ m
r ɛ p uː ŋ n aː r ɛ	r ɛ p ʊ ŋ n aː r ɛ
t a l p aː a m	t a l p a m
a d mː ɪ n ɪ s t r aː r ɛ	a d m ɪ n ɪ s t r aː r ɛ
d ɪ s t r aː k t j oː n ɛ m	d ɪ s t r a k t j oː n ɛ m
s ɛ k t ɪ m a n a m	s ɛ p t ɪ m aː n a m
ɔ d j ʊ m	ɔ d j ʊ m
n ɛ k sː ʊ m	n ɛ k s ʊ m
m ɔ r t aː r j ʊ m	m ɔ r t aː r j ʊ m
r ɛ n aː r ɛ	r eː ŋ n aː r ɛ
a g aː t a m	a kʰ aː t eː n
g ɛ m ɪ n aː t j oː n ɛ m	g ɛ m ɪ n aː t j oː n ɛ m
ɪ rː ɛ g ʊ l aː r ɛ	ɪ rː eː g ʊ l aː r ɛ m
p r ɛ d ɔ m ɪ n aː r ɛ	p r aɪ d ɔ m ɪ n aː r iː
k aː l k ɛ m	k a l k ɛ m
k uː r a m t uː r a m	k uː r aː t uː r a m
k ɔ n f ɪ s k aː r ɛ	k oː n f ɪ s k aː r ɛ
k ɔ n s ɛ kʷ ɛ n t j a m	k oː n s ɛ kʷ ɛ n t j a m
p r ɪ n k ɪ p aː l ɪ t aː t ɛ m	p r ɪ ŋ k ɪ p aː l ɪ t aː t ɛ m
r ɛ k ɛ d ɛ r ɛ	r ɛ k eː d ɛ r ɛ
f l ɛ k sː ɪ b ɪ l ɪ t aː t ɛ m	f l ɛ k s ɪ b ɪ l ɪ t aː t ɛ m
p ɛ r k ɪ r ɪ r ɛ	p ɛ r kʷ iː r ɛ r ɛ
s ɪ l w a m	s ɪ l w a m
k aː l ɪ d ɪ t aː	k a l ɪ d ɪ t aː t ɛ m
f ɛ m rː aː m j ɛ n t aː	f ɛ rː aː m ɛ n t ʊ m
k ɔ n s ɛ r w aː r ɛ	k oː n s ɛ r w aː r ɛ
ɪ sː ɪ m ʊ m	ɪ sː ɪ m ʊ m
w ɪ s aː r ɛ	w iː s ɛ r ɛ
m ɛ d ɪ k ɪ n aː l ɛ	m ɛ d ɪ k iː n aː l ɛ m
a b uː s aː r ɛ	a b uː t iː
ɪ n k aʊ t ʊ m	ɪ ŋ k aʊ t ʊ m
ɔ n ɔ r aː b ɪ l ɛ	h ɔ n oː r aː b ɪ l ɛ m
a s aː r ʊ m	a s a r ʊ m
a t aː r ɛ	a p t aː r ɛ
r ɛ m g aː r ɛ	r ɪ g aː r ɛ
d ɛ s t ɪ n aː r ɛ	d eː s t ɪ n aː r ɛ
p l ʊ m b oː s ʊ m	p l ʊ m b oː s ʊ m
m aː n ɪ f j ɛ s t ʊ m	m a n ɪ f ɛ s t ʊ m
k ʊ lː ɛ k ʊ j ʊ m	k aʊ l ɪ k ʊ l ʊ m
ɪ n f aː n t ʊ m	iː n f a n d ʊ m
r ɛ t r ɔ k ɛ d ɛ r ɛ	r ɛ t r oː k eː d ɛ r ɛ
ɔ m ɛ n t ʊ m	oː m ɛ n t ʊ m
a d aː m a n t ɛ m	a d a m a n t ɛ m
g aː rː ʊ l ʊ m	g a rː ʊ l ʊ m
d ɪ s s p ɛ r aː t j oː n ɛ m	d eː s p eː r aː t j oː n ɛ m
d ɛ m oː r aː r ɛ	d eː m ɔ r aː r iː
k oː n s k ʊ m	k oː n s k j ʊ m
k aː r a m	k a r a m
k j ɛ r w a m	k ɛ r w a m
m a r ɪ t ʊ m	m a r iː t ʊ m
w eː l a m	w eː l ʊ m
b r ɪ ɪ w ɛ t aː t ɛ m	b r ɛ w ɪ t aː t ɛ m
b ʊ k j ɪ n ɛ	b uː k ɪ n ʊ m
p ɛ r p ɛ m t aː t j ʊ m n ɛ m	p ɛ r p ɛ t w aː t oː n ɛ m
a n t ɪ s t ɪ t ɛ m	a n t ɪ s t ɪ t ɛ m
m ɛ m b r aː n ʊ m s ʊ m	m ɛ m b r aː n ɛu m
k ɪ b aː t j oː n ɛ m	k ɪ b aː t j oː n ɛ m
ɛ w ɔ k aː t j oː n ɛ m	eː w ɔ k aː t j oː n ɛ m
f r aː t ɛ r n ʊ m	f r aː t ɛ r n ʊ m
ɪ l aː r ɛ	h ɪ l a r ɛ m
ɛ k s p oː n ɛ	ɛ k s p oː n ɛ r ɛ
ɛ r ɔ d ɛ r ɛ	eː r oː d ɛ r ɛ
t r a n s ɪ r ɛ	t r aː n s iː r ɛ
p ɛ r s k r ʊ t aː r ɛ	p ɛ r s k r uː t aː r iː
s t uː d j aː r ɛ	s t ʊ d eː r ɛ
ɔ b l ɪ t ɛ r aː r ɛ	ɔ b l ɪ tː ɛ r aː r ɛ
n ɛ k t aː r ɛ	n ɛ k t a r
ɔ d j ɛ r n ʊ m	h ɔ d ɪ ɛ r n ʊ m
a l t ɛ r n aː t j ʊ m n ɛ	a l t ɛ r n aː t j oː n ɛ m
ɪ n k ɔ m ɔ d aː r ɛ	ɪ ŋ k ɔ mː ɔ d aː r ɛ
s ɛ m kʷ aː k ɛ	s ɛ kʷ aː k ɛ m
s p uː t ʊ m	s p uː t ʊ m
r ʊ b oː r ɛ	r ʊ b oː r ɛ m
k ɛ lː aː	k ɛ lː a m
f aː r ɛ l ʊ m	f a r
kʷ ɛ s t j oː n ɛ	kʷ aɪ s t j oː n ɛ m
m ɪ ŋ ŋ aː m	m ɛ n t ʊ l a m
p ɛ r s ɛ kʷ ɪ r ɛ	p ɛ r s ɛ kʷ iː
f ɔ r ʊ m	f ɔ r ʊ m
t ʊ r t ʊ r m a	t ʊ r t ʊ r ɛ m
t r ɪ b ʊ l ʊ m	t r ɪ b ʊ l ʊ m
w ɪ d ʊ w a m	w ɪ d w a m
k ɔ n d ɪ t j oː n ɛ	k ɔ n d ɪ k j oː n ɛ m
ɛ b r ɛ ʊ m	h ɛ b r aɪ ʊ m
l ʊ b r ɪ k ɪ t aː	l uː b r ɪ k ɪ t aː t ɛ m
d uː k aː t ʊ m	d ʊ k aː t ʊ m
p ɔ lː aː r j ʊ m	p ʊ lː aː r j ʊ m
k ɔ n s ɪ l ʊ m	k ɔ ŋ k ɪ l j ʊ m
l ɪ n ɛ aː r ɛ	l iː n ɛ aː r ɛ
b r a n k a m	b r a ŋ k a m
w ɪ k ɪ n a m	w iː k iː n a m
ɛ k s ɪ gʷ ʊ m	ɛ k s ɪ gʷ ʊ m
f j ɛ r a m	f ɛ r a m
a b g ʊ r aː t j oː n ɛ m	a b ɪ uː r aː t j oː n ɛ m
w aː r oː n ɛ m	w aː r oː n ɛ m
n ɔ r m a m	n oː r m a m
f ɪ r ɛ	f ɪ ɛ r iː
d ɛ s k r ɪ p t j oː n ɛ m	d eː s k r iː p t j oː n ɛ m
p ʊ l w ɛ r ɪ zː aː r ɛ	p ʊ l w ɛ r iː zː aː r ɛ
ɛ f ɛ k t aː ɛ r ɛ	ɛ fː ɪ k ɛ r ɛ
l ʊ s k ʊ m	l ʊ s k ʊ m
d ɛ n t ɪ f r ɪ k ʊ m	d ɛ n t ɪ f r ɪ k j ʊ m
f r ɛ kʷ ɛ n t ɛ m	f r ɛ kʷ ɛ n t ɛ m
k ɛ r w ʊ s j a m	k ɛ r w ɛ s j a m
k ɪ k m ʊ	k ɪ kː ʊ m
k ɔ m ɪ n ʊ m	k ʊ m iː n ʊ m
p ɛ k uː l j ʊ m	p ɛ k uː l j ʊ m
f aː r m aː k ʊ m	pʰ a r m a k ʊ m
ɔ n ɔ r ɪ f ɪ k ʊ m	h ɔ n oː r ɪ f ɪ k ʊ m
p r ɔ w ɔ k aː t oː r ɛ	p r oː w ɔ k aː t oː r ɛ m
l ʊ t ʊ m	l ʊ t ʊ m
s uː p ɛ r j oː r ɛ	s ʊ p ɛ r j oː r ɛ m
b aː t ɪ s t ɛ r j ʊ m	b a p t ɪ s t eː r j ʊ m
a m p l ɪ t uː	a m p l ɪ t uː d ɪ n ɛ m
a s k ɛ n s j oː n ɛ m	a s k eː n s j oː n ɛ m
ɔ s k ʊ l ʊ m	oː s k ʊ l ʊ m
s t aː b ɪ l ɛ m k ɛ r ɛ	s t a b ɪ l iː r ɛ
f ɪ l j aː l ɛ	f iː l j aː l ɛ m
t r ɛ ʊ m	t r a k t ʊ m
s p ɔ l j ʊ m	s p ɔ l j ʊ m
f l aː kː ʊ m	f l a kː ʊ m
g uː d ɛ m ʊ m	j uː d aɪ ʊ m
l a k r ɪ m aː r ɛ	l a k r ɪ m aː r ɛ
d ɛ m t r aː ɪ r ɛ	d eː t r a h ɛ r ɛ
p ɛ r ɪ t j aː	p ɛ r iː t j a m
a m a r ɪ g a r ɛ	a m aː r ɪ k aː r ɛ
uː s ɪ t aː t ʊ m	uː s ɪ t aː t ʊ m
ɪ n k ɔ l aː	ɪ ŋ k ɔ l a m
s ʊ p ɛ r ɛ m pː oː n ɛ	s ʊ p ɛ r p oː n ɛ r ɛ
k ɪ	kʷ ɪ s
w j ɔ l aː r ɛ	w ɪ ɔ l aː r ɛ
f ɔ r t ɛ m	f ɔ r t ɛ m
k uː r aː r ɛ	k uː r aː r ɛ
t aː r d aː r ɛ	t a r d aː r ɛ
p r ɛ t ɛ n d ɛ r ɛ	p r aɪ t ɛ n d ɛ r ɛ
t r a n s ɪ t ʊ m	t r aː n s ɪ t ʊ m
k ɪ r k ʊ l aː r ɛ	k ɪ r k ʊ l aː r ɛ
ɔ n ɔ r aː r j ʊ m	h ɔ n oː r aː r j ʊ m
g l aː n d ʊ l oː s ʊ m	g l a n d ʊ l oː s ʊ m
r ɛ g ʊ l aː r ɛ	r eː g ʊ l aː r ɛ m
d ɛ s p l eː g aː r ɛ	d ɪ s p l ɪ k aː r ɛ
r ɛ p aː r aː r ɛ	r ɛ p a r aː r ɛ
uː s t ʊ l aː r ɛ	ʊ s t ʊ l aː r ɛ
k aː m ɪ n ʊ m	k a m iː n ʊ m
ɪ m b ɛ k ɪ lː ɪ t aː t ɛ m	ɪ m b eː k ɪ lː ɪ t aː t ɛ m
ɪ n d uː r aː r ɛ	ɪ n d uː r aː r ɛ
s uː pː l ɪ k aː r ɛ	s ʊ pː l ɪ k aː r ɛ
p oː m ɪ k ɛ	p uː m ɪ k ɛ m
p r ɔ a m	p r oː r a m
ɔ l ɪ g aː r k a m	ɔ l ɪ g a r kʰ a m
r ɛ s t ɪ t ʊ ɛ r ɛ	r ɛ s t ɪ t ʊ ɛ r ɛ
d ʊ l k ɪ t ʊ m d ɪ r ɛ	d ʊ l k ɪ t uː d ɪ n ɛ m
l ɪ k t oː r ɛ	l iː k t oː r ɛ m
d ɪ t ʊ m	d ɪ k t ʊ m
r ɛ f l uː ɪ r ɛ	r ɛ f l ʊ ɛ r ɛ
m aː t ɛ r n ʊ m m	m aː t ɛ r n ʊ m
d ɪ m ɛ t ɛ r ɛ	d iː m ɪ tː ɛ r ɛ
d ɛ t ɛ s t aː t j oː n ɛ m	d eː t ɛ s t aː t j oː n ɛ m
d ɪ s t ɪ n k t ʊ m	d ɪ s t ɪ ŋ k t ʊ m
k aː t ɛ d r aː l ɛ	k a tʰ ɛ d r aː l ɛ m
p ɪ t j ʊ m	p iː k ʊ m
s k r ʊ t aː r ɛ	s k r uː t aː r ɛ
ɪ n d ɪ ŋ n aː t j oː n ɛ m	ɪ n d ɪ ŋ n aː t j oː n ɛ m
b a l t ɪ k ʊ m	b a l t ɪ k ʊ m
s ɔ l ʊ m	s ɔ l ʊ m
k ɪ k ɛ m	k ɪ k ɛ r
f aː t ɛ m	f a k ɪ ɛ m
ʊ s ɪ n ɔ l ʊ m	l ʊ s k ɪ n j a m
a d ɔ r m ɪ r ɪ	a dː ɔ r m iː r ɛ
f ɛ m ɛ l a m	f eː m ɛ lː a m
k r ɔ t aː l ʊ m	k r ɔ t a l ʊ m
ɛ ʊ m	ɛu m
t aː b ɛ r n a m	t a b ɛ r n a m
a n aː l ɪ s ɪ s	a n a l y s ɛ m
k ɔ l ɔ r aː r ɛ	k ɔ l oː r aː r ɛ
p r ɔ k ɛ lː a m	p r ɔ k ɛ lː a m
f aʊ k ɪ	f aʊ k eː s
g uː b ɪ l aː r ɛ	j uː b ɪ l aː r ɛ
d ɛ k ɪ m ʊ m	d ɛ k ɪ m ʊ m
l ɪ t uː r g j a m	l iː t uː r g j a m
k ʊ l m ʊ m	k ʊ l m ʊ m
g ɛ m ɪ t ʊ m	g ɛ m ɪ t ʊ m
p ʊ l k r ɛ ɪ t ʊ t ɛ m	p ʊ l kʰ r ɪ t uː d ɪ n ɛ m
k r ʊ k ɪ f ɛ r ʊ m	k r ʊ k ɪ f ɛ r ʊ m
s ʊ ɪ n ʊ m	s ʊ iː n ʊ m
k ɔ n s ɪ l a m r ɛ	k ɔ ŋ k ɪ l j aː r ɛ
k ɔ aː b ɪ t a m r ɛ	k ɔ h a b ɪ t aː r ɛ
w ɪ ŋ k ɛ r ɛ	w ɪ ŋ k ɛ r ɛ
ɔ kː aː s j ʊ n ɛ	ɔ kː aː s j oː n ɛ m
a sː ɪ s ʊ m	a sː ɛ sː ʊ m
a m aː r ɛ	a m aː r ɛ
r ɛ p r ɛ h ɛ n s j oː n ɛ m	r ɛ p r ɛ h ɛ n s j oː n ɛ m
d ɪ s k ʊ rː ɛ r ɛ	d ɪ s k ʊ rː ɛ r ɛ
k ʊ r w aː r ɛ	k ʊ r w aː r ɛ
n ɛ r w oː s ʊ m	n ɛ r w oː s ʊ m
m ʊ sː ɪ t aː r ɛ	m ʊ sː ɪ t aː r ɛ
g ɔ k ʊ n d ɪ t aː t ɛ m	j uː k ʊ n d ɪ t aː t ɛ m
g ɛ m ɪ n aː r ɛ	g ɛ m ɪ n aː r ɛ
l ɪ n ʊ m	l iː n ɛu m
w aː lː ʊ m	w a lː ʊ m
s ʊ b ɪ t aː n ɛ ʊ m	s ʊ b ɪ t aː n ɛu m
m ɛ m ɔ b r aː r ɛ	m ɛ m ɔ r aː r ɛ
k ʊ n s oː b r ɪ n ʊ m	k oː n s oː b r iː n ʊ m
b a k ʊ m l ʊ m	b a k ʊ l ʊ m
ɪ n k uː b ʊ m	ɪ ŋ k ʊ b ʊ m
g l ʊ t ɪ n ɛ	g l uː t ɛ n
s uː d aː r ɛ	s uː d aː r ɛ
k ɔ n d ɛ n s aː r ɛ	k ɔ n d eː n s aː r ɛ
d ɛ p ɛ r d ɪ t j ʊ m n ɛ m	d eː p ɛ r d ɪ t j oː n ɛ m
f aː k ʊ n d j a m	f aː k ʊ n d j a m
r ɛ p ɛ lː ɛ r ɛ	r ɛ p ɛ lː ɛ r ɛ
k ʊ lː ʊ m k aː r ɛ	k ɔ lː ɔ k aː r ɛ
p r ɔ t ɛ s t aː t j oː n ɛ m	p r oː t ɛ s t aː t j oː n ɛ m
t oː r ɛ ʊ w ɪ s k ʊ m	t ʊ r b ɪ s k ʊ m
s ʊ s p aː s ɛ m	s ʊ s p ɛ k t j oː n ɛ m
l aː t ɪ t uː d ɪ n ɛ m	l aː t ɪ t uː d ɪ n ɛ m
a ŋ ɛ lː a m	a ŋ n ɛ lː a m
f a b r ɪ k aː r ɛ	f a b r ɪ k aː r ɛ
s ʊ r t ɪ r ɛ	s ɔ r t iː r iː
ɛ l ɔ ŋ g aː t j oː n ɛ m	eː l ɔ ŋ g aː t j oː n ɛ m
a s t ʊ r ɛ	a s t ʊ r ɛ m
s aː p eː r ɛ	s a p ɛ r ɛ
p l aː n aː r ɛ	p l aː n aː r j ʊ m
l ʊ k b r ɛ ɛ k aː r	l uː k ʊ b r aː r ɛ
d ɔ l oː s ʊ m	d ɔ l oː s ʊ m
k ɔ n s ɪ s t ɛ r ɛ	k oː n s ɪ s t ɛ r ɛ
p r a n d s ʊ m	p r a n d j ʊ m
d ɔ k t oː r ɛ	d ɔ k t oː r ɛ m
d ɛ l aː t j oː n ɛ m	d eː l aː t j oː n ɛ m
k ʊ p uː l aː r ɛ	k oː p ʊ l aː r ɛ
s t aː t ɛ r a m	s t a t eː r a m
ɔ l ɛ aː t ʊ m	ɔ l ɛ aː t ʊ m
k a r n oː s ʊ m	k a r n oː s ʊ m
m ɛ m r k aː r ɛ	m ɛ r k aː r iː
f ʊ s t aː	f ʊ s t a m
f r aː sː ɪ n ʊ m	f r a k s ɪ n ʊ m
s ʊ kː ʊ l ɛ n t ʊ m	s ʊ kː ʊ l ɛ n t ʊ m
d ɛ k r ɛ t aː l ɛ	d eː k r eː t aː l ɛ m
s ɔ n a m t oː r ɛ	s ɔ m n j aː t oː r ɛ m
ɛ r b aː r j ʊ m	h ɛ r b aː r j ʊ m
d ɪ fː ɛ r ɪ r ɛ	d ɪ fː ɛ rː ɛ
f r uː ɛ k t ʊ m	f r uː k t ʊ m
m ɛ m t ɪ r ɛ	m eː t iː r iː
p ɛ r s ɪ s t ɛ r ɛ	p ɛ r s ɪ s t ɛ r ɛ
t ɔ r ʊ m	t aʊ r ʊ m
t r aː m ɪ t ɛ m	t r aː m ɪ t ɛ m
w ɛ s t ɪ t ʊ m	w ɛ s t iː t ʊ m
s ɛ p ʊ l k r ʊ m	s ɛ p ʊ l k r ʊ m
a s k r ɪ w ɛ r ɛ	aː s k r iː b ɛ r ɛ
a fː l ɪ g ɛ r ɛ	a fː l iː g ɛ r ɛ
kʷ ɪ n t ʊ m	kʷ iː n t ʊ m
d ɪ s k r ɛ m p aː n t j aː	d ɪ s k r ɛ p a n t j a m
a ŋ n aː t ʊ m	a ŋ n aː t ʊ m
ɪ mː aː t uː r ɪ t aː t ɛ m	ɪ mː aː t uː r ɪ t aː t ɛ m
a r m aː r j ʊ m	a r m aː r j ʊ m
r ɛ m ʊ n ɛ r aː r ɛ	r ɛ m uː n ɛ r aː r ɛ
ɔ fː ɪ k ʊ m s j ʊ m	ɔ fː ɪ k j oː s ʊ m
p ʊ n aː r ɛ	p ʊ ŋ n aː r ɛ
s aː k r ɪ f ɪ k aː t oː r ɛ	s a k r ɪ f ɪ k aː t oː r ɛ m
ɛ m uː l ʊ m	aɪ m ʊ l ʊ m
a s ɛ t aː t ɛ m	a s eː ɪ t aː t ɛ m
ɪ n t ɛ g r a m r ɛ	ɪ n t ɛ g r aː r ɛ
r ʊ t a m r ɛ	r ʊ k t aː r ɛ
r ɪ m a n ɛ r ɛ	r ɛ m a n eː r ɛ
r ɛ t r ɪ b ʊ iː r ɛ	r ɛ t r ɪ b ʊ ɛ r ɛ
j uː r a m t oː r ɛ	j uː r aː t oː r ɛ m
n ɛ f aː s	n ɛ f aː s
p ɛ n s ʊ m	p eː n s ʊ m
a m b r oː s j a m	a m b r ɔ s j a m
s ɛ k uː r ɛ m	s ɛ k uː r ɛ m
a pː ɛ n d ɛ r ɛ	a pː ɛ n d ɛ r ɛ
k ɛ r t ɛ n aː r ɛ	k ɪ r k ɪ n aː r ɛ
w ɛ lː ʊ s ʊ m	w ɪ lː oː s ʊ m
b ɛ n ɛ f ɪ k j ʊ m	b ɛ n ɛ f ɪ k j ʊ m
