ɪ n f l ɪ k t j oː n ɛ m	ɪ n f l ɪ k t j oː n ɛ m
ɪ n k ɛ n d j aː r j ʊ m	ɪ ŋ k ɛ n d j aː r j ʊ m
ɛ k s aː k t j oː n ɛ m	ɛ k s aː k t j oː n ɛ m
k ɛ lː aː	k ɛ lː a m
p r ɪ m ɔ g ɛ n ɪ t ʊ m	p r iː m oː g ɛ n ɪ t ʊ m
k ɛ l aː r ɛ	k eː l aː r ɛ
a pː r ɔ p r j aː t j oː n ɛ m	a pː r ɔ p r j aː t j oː n ɛ m
s a r g ʊ m	s a r g ʊ m
k ɔ m p r oː m ɛ t ɛ r ɛ m	k ɔ m p r oː m ɪ tː ɛ r ɛ
k ɔ m p r a m t oː r ɛ	k ɔ m p a r aː t oː r ɛ m
t r aː m a m	t r aː m a m
m uː l ʊ m	m uː l ʊ m
m ɛ s ɛ m	m eː n s ɛ m
a d j ʊ ŋ g ɛ r ɛ	a d j ʊ ŋ g ɛ r ɛ
p ɛ r s w aː d ɛ r ɛ m	p ɛ r s w aː d eː r ɛ
l aʊ d ɛ	l aʊ d ɛ m
ʊ ŋ t ʊ m s ʊ m	uː ŋ k t ʊ oː s ʊ m
l a n oː s ʊ m	l aː n oː s ʊ m
p ɛ r g ʊ r ʊ m	p ɛ r ɪ uː r ʊ m
f ʊ ŋ g ɛ r ɛ	f ʊ ŋ g iː
t ɪ t ʊ b eː r ɛ	t ɪ t ʊ b aː r ɛ
b l ɛ t ʊ m	b l ɪ t ʊ m
ɔ l ɛ aː t ʊ m	ɔ l ɛ aː t ʊ m
p r ɛ t ɛ k s t aː r ɛ	p r aɪ t ɛ k s ɛ r ɛ
m ʊ n ɔ s	m uː n ʊ s
m a t r ɪ t ɪ d a m	m aː t r ɪ k iː d a m
k a r n ɪ r ʊ m	k a r n aː r j ʊ m
a k s ɪ l j ʊ m	aʊ k s ɪ l j ʊ m
s ʊ p r ɛ m nː aː t uː r aː l ɛ m	s ʊ p ɛ r n aː t uː r aː l ɛ m
p r ɛ d aː r ɛ	p r aɪ d aː r iː
m ɔ n ɛ t a m	m ɔ n eː t a m
t r ɪ lː ʊ m	t r iː b ʊ l ʊ m
p r ɔ w ɔ k aː r ɛ	p r oː w ɔ k aː r ɛ
a s k ʊ m s ʊ m	a b s k ɔ n s ʊ m
a kː ɪ s ɪ t j oː n ɛ m	a kː w ɪ s iː t j oː n ɛ m
d ɛ s p l ɛ m g aː r ɛ m	d ɪ s p l ɪ k aː r ɛ
s a k r ɪ f ɪ k j ʊ m	s a k r ɪ f ɪ k j ʊ m
r ɛ g ʊ l a m	r eː g ʊ l a m
p ʊ g ɪ l ɛ	p ʊ g ɪ l ɛ m
g a rː ɪ r ɛ	g a rː iː r ɛ
s ɛ ŋ t ɪ r ɛ	s ɛ n t iː r ɛ
ɪ n mː ɔ l aː t j oː n ɛ m	ɪ mː ɔ l aː t j oː n ɛ m
k ɔ n s ɛ r w aː r ɛ m	k oː n s ɛ r w aː r ɛ
l ɪ b ɛ r aː t j oː n ɛ m	l iː b ɛ r aː t j oː n ɛ m
k a lː ɪ d ʊ m	k a lː ɪ d ʊ m
k ɔ n t ʊ r b aː r ɛ m	k ɔ n t ʊ r b aː r ɛ
f ɪ k ʊ m	f iː k ʊ m
m ɔ k ʊ n ɛ m ɛ m	m uː t ʊ l ʊ m
l ɪ b r ʊ m	l iː b ɛ r ʊ m
t r a n s m ɪ t ɛ r ɛ m	t r aː n s m ɪ tː ɛ r ɛ
f ɪ n oː k ʊ j ʊ m m	f eː n ʊ k ʊ l ʊ m
uː n ɪ k ʊ m	uː n ɪ k ʊ m
d ɛ t ɛ n ɛ r ɛ	d eː t ɪ n eː r ɛ
s p oː s ʊ m	s p oː n s ʊ m
g ɔ b j ʊ m n ɛ m	g oː b j ʊ m
k ɔ n t aː r ɛ	k ɔ m p ʊ t aː r ɛ
s ɔ n ɪ t ʊ m	s ɔ n ɪ t ʊ m
t ʊ sː ɛ r ɛ	t ʊ sː iː r ɛ
a l t ɛ r k aː t j oː n ɛ m	a l t ɛ r k aː t j oː n ɛ m
g a lː ɛ g ʊ m	g a lː aɪ k ʊ m
s ɔ d aː l ɪ t aː	s ɔ d aː l ɪ t aː t ɛ m
a ɪ k j aː k ʊ m	aɪ g y p t j a k ʊ m
k uː k ɪ n a m	k ɔ kʷ iː n a m
k ɔ n s t ɪ t ʊ t ɪ w ʊ m	k ɔ n s t ɪ t uː t ɪ w ʊ m
d a n aː r ɛ	d a m n aː r ɛ
a g ɪ t a m t oː r ɛ	a g ɪ t aː t oː r ɛ m
g ɛ r m ɛ m n	g ɛ r m ɛ n
j uː s t ʊ m	j uː s t ʊ m
f ɔ ŋ g oː s ʊ m	f ʊ ŋ g oː s ʊ m
k ɔ m p ʊ n g ɛ r ɛ m	k ɔ m p ʊ ŋ g ɛ r ɛ
f ɛ n ʊ m	f aɪ n ʊ m
a pː r oː k aː r ɛ	a pː r ɔ p j aː r ɛ
t r ɪ ʊ n f a m t oː r ɛ m	t r j ʊ m pʰ aː t oː r ɛ m
n ɛ g l ɪ j ɛ n t j a m	n ɛ g l ɛ g ɛ n t j a m
ɔ r d ɪ n aː r j ʊ m	oː r d ɪ n aː r j ʊ m
w ɪ t ʊ p ɛ r aː b ɪ l ɛ m	w ɪ t ʊ p ɛ r a b ɪ l ɛ m
w ɪ w aː k ɛ	w iː w aː k ɛ m
k ɔ n f l ɪ k t ʊ m	k oː n f l ɪ k t ʊ m
k ɔ m p aː t r ɛ m	k ɔ m p a t r ɛ m
d ɛ s ɛ r t ʊ m	d eː s ɛ r t ʊ m
r ɔ m aː n oː	r oː m aː n ʊ m
k ɔ n s k ɛ j ɛ n t j a m	k oː n s k ɪ ɛ n t j a m
b a s ɪ l ɪ s k ʊ m	b a s ɪ l ɪ s k ʊ m
a b s t ɛ r g ɛ r ɛ m	a b s t ɛ r g eː r ɛ
t r a n s m ɪ sː j oː n ɛ m	t r aː n s m ɪ sː j oː n ɛ m
r aː t ʊ m	r ɛ aː t ʊ m
f ɛ m ɔ r aː l ɛ	f ɛ m ɔ r aː l ɛ m
a k ɪ t aː r ɛ	oː s k ɪ t aː r ɛ
p a g aː n ɪ s m ʊ m	p aː g aː n ɪ s m ʊ m
a r b ɔ r ɛ t ʊ m	a r b ɔ r eː t ʊ m
k a l k ʊ l ʊ m	k a l k ʊ l ʊ m
a b ɪ l ɛ	aː b ɪ l ɛ m
k ɪ d j ʊ m	k iː d j ʊ m
s a l t aː t j ʊ m n ɛ m	s a l t aː t j oː n ɛ m
d ɛ k r ɛ m ɛ n t ʊ m	d eː k r eː m ɛ n t ʊ m
ɛ k s p ɪ r aː t j oː n ɛ m	ɛ k sː p iː r aː t j oː n ɛ m
ɛ s ɛ kʷ j ɛ m s	ɛ k sː ɛ kʷ j a m
m ɪ n oː r ɛ	m ɪ n oː r ɛ m
n ʊ m ɛ r aː r ɛ	n ʊ m ɛ r aː r ɛ
k ʊ l ɛ	k aʊ l ɛ m
m ʊ l k ɛ r ɛ	m ʊ l k eː r ɛ
ɪ ŋ gʷ ɪ n ɛ m	ɪ ŋ gʷ ɛ n
a b ɪ t aː t j oː n ɛ m	h a b ɪ t aː t j oː n ɛ m
m a l ɪ ŋ n ʊ m	m a l ɪ ŋ n ʊ m
l a k aː r ɛ	l a sː aː r ɛ
ɪ n d ɪ ŋ n aː t j oː n ɛ m	ɪ n d ɪ ŋ n aː t j oː n ɛ m
k ɔ n w ɛ k sː ʊ m	k ɔ n w ɛ k s ʊ m
d ɛ t ɛ s t aː r ɛ	d eː t ɛ s t aː r iː
k ɔ n s ɔ l ɪ d aː r ɛ	k oː n s ɔ l ɪ d aː r ɛ
b ɛ l ʊ w a m r j	b eː l w a m
w ɔ n l ʊ n t ɛ m m	w ɔ l ʊ n t aː t ɛ m
w ɛ r n aː l ɛ	w ɛ r n aː l ɛ m
s uː b s ɪ d j ʊ m	s ʊ b s ɪ d j ʊ m
s a ŋ gʷ ɪ r aː r ɛ	s a ŋ gʷ ɪ n aː r ɛ
k ɔ n k ɛ d ɛ r ɛ	k ɔ ŋ k eː d ɛ r ɛ
s ʊ p ɪ n ʊ m	s ʊ p iː n ʊ m
p l ʊ m b aː r ʊ m	p l ʊ m b aː r j ʊ m
w ɛ t r ɪ k ɛ	w iː t ɪ k ɛ m
r ɛ t r aː r ɛ	r ɛ t r a h ɛ r ɛ
k ɔ n g ʊ n g ɛ r ɛ	k ɔ n j ʊ ŋ g ɛ r ɛ
ɔ d j ɪ ɛ r n ʊ m	h ɔ d ɪ ɛ r n ʊ m
l ɛ t ʊ m	l eː k t ʊ m
f ʊ n d a m m ɛ n t ʊ m	f ʊ n d aː m ɛ n t ʊ m
d j aː l ɛ k t ʊ m	d j a l ɛ k t ɔ n
s ʊ mː ɪ t aː t ɛ m	s ʊ mː ɪ t aː t ɛ m
f a b r ɪ k aː r ɛ	f a b r ɪ k aː r ɛ
ɪ n w ɪ t aː r ɛ	ɪ n w iː t aː r ɛ
b ʊ w aː r ʊ m	b ɔ w aː r j ʊ m
k r ɪ t ɛ r j ʊ m	k r ɪ t ɛ r ɪ ɔ n
a dː ɪ t j oː n ɛ	a dː ɪ t j oː n ɛ m
s uː b ɔ r n aː r ɛ	s ʊ b oː r n aː r ɛ
m ɔ r ɪ b ʊ n d ʊ m	m ɔ r ɪ b ʊ n d ʊ m
ɔ r t ɔ g r aː f j a m	ɔ r tʰ ɔ g r a pʰ j a m
k oː m b a m	k ʊ m b a m
f ɪ d ɛ l ɛ	f ɪ d eː l ɛ m
ɪ n ʊ s ɪ t aː t ʊ m	ɪ n uː s ɪ t aː t ʊ m
uː l k ɛ r a m	ʊ l k ʊ s
p r ɔ l ɔ ŋ g aː t j oː n ɛ m	p r oː l ɔ ŋ g aː t oː n ɛ m
f a t ʊ m	f aː t ʊ m
w ɔ l ʊ b ɪ l ɛ	w ɔ l uː b ɪ l ɛ m
b ɛ s t ɪ oː l a m	b eː s t ɪ ɔ l a m
s t r ɛ p ɪ t ʊ m	s t r ɛ p ɪ t ʊ m
s a l w ʊ m	s a l w ʊ m
a r m ɪ g ɛ m r ʊ m	a r m ɪ g ɛ r ʊ m
f ɛ mː ɪ n ɪ n ʊ m	f eː m ɪ n iː n ʊ m
ɔ l ʊ m	ʊ l ʊ m
b r ɪ ɛ w ɛ t aː m	b r ɛ w ɪ t aː t ɛ m
m a r ɪ t aː r ɛ	m a r iː t aː r ɛ
m ʊ s aː r aː n ʊ m	m uː s a r aː n ɛu m
s t r ɪ d ɛ r ɛ	s t r iː d ɛ r ɛ
ɔ l ɪ g aː r k ɪ k ʊ m	ɔ l ɪ g a r kʰ ɪ k ʊ m
s a aː w ɪ t aː	s w aː w ɪ t aː t ɛ m
ɛ k s ɔ r t aː r ɛ	ɛ k s h ɔ r t aː r iː
k r ɛ m aː	k r aː m ʊ m
p ɔ s aː r ɛ	p aʊ s aː r ɛ
a d ɪ k t j oː n ɛ m ɛ m	a dː ɪ k t j oː n ɛ m
t r aː b ɛ k ʊ l a m	t r a b eː k ʊ l a m
p ɔ l ʊ m	p ɔ l ʊ m
s k ʊ rː ɛ r ɛ	ɛ k s k ʊ rː ɛ r ɛ
s k r ʊ t ɪ n j ʊ m	s k r uː t ɪ n j ʊ m
w ɛ r m ɪ n oː s ʊ m	w ɛ r m ɪ n oː s ʊ m
l uː k ɪ n ʊ m l oː	ɛ lː y kʰ n j ʊ m
w ɔ r t ɪ k k ɛ m	w ɔ r t ɪ k ɛ m
aʊ d aː k ɛ	aʊ d aː k ɛ m
s a n j ɛ m	s a n ɪ ɛ m
p l aː t aː n ʊ m	p l a t a n ʊ m
a k ʊ m ɪ n aː r ɛ	a k uː m ɪ n aː r ɛ
d ɛ f r aʊ d a m t j oː n ɛ m	d eː f r aʊ d aː t j oː n ɛ m
p a r ɔ n oː m aː s j a m	p a r ɔ n ɔ m a s j a m
s a t ɪ s f aː k ɛ r ɛ	s a t ɪ s f a k ɛ r ɛ
w ɪ d ʊ w a m	w ɪ d w a m
a p ɔ k aː l ɪ p sː ɛ m m	a p ɔ k a l y p s ɛ m
t a k t ɪ l ɛ	t aː k t ɪ l ɛ m
k oː n ɔ p ɛ ʊ m	k oː n oː p eː ʊ m
r ɛ k l aː m aː t j oː n ɛ m	r eː k l aː m aː t j oː n ɛ m
uː n ɪ w ɔ k ʊ m	uː n ɪ w ɔ k ʊ m
f a k ʊ n d ʊ m	f aː k ʊ n d ʊ m
k ɔ m p ɔ r t aː r ɛ m	k ɔ m p ɔ r t aː r ɛ
ɔ t r ɛ	ʊ t r ʊ m
ɔ r ɪ f ɪ k ʊ m	h ɔ rː ɪ f ɪ k ʊ m
g ɛ m ɪ n a m t j oː n ɛ m	g ɛ m ɪ n aː t j oː n ɛ m
t r ɛ m ʊ l a r ɛ	t r ɛ m ʊ l aː r ɛ
s ʊ p r a m kː r ɛ m s k ɛ m r ɛ m	s ʊ p ɛ r k r eː s k ɛ r ɛ
p r ɛ s t aː t j oː n ɛ m	p r aɪ s t aː t j oː n ɛ m
w aː n oː	w aː n ʊ m
a m ɛ n ɪ t aː t ɛ m	a m ɔ ɪ n ɪ t aː t ɛ m
m ʊ n ɪ r ɛ	m ɔ n eː r ɛ
ɛ k s p ʊ l s aː r ɛ	ɛ k s p ʊ l s aː r ɛ
k ɔ r t ɪ k ɛ m	k ɔ r t ɪ k ɛ m
r ɪ t ʊ m	r iː t ʊ m
t r ɪ b ʊ t ʊ m	t r ɪ b uː t ʊ m
t ɛ rː ɛ n ʊ m	t ɛ rː eː n ʊ m
d a t a m	d a t a
p r ɛ t ɛ r n aː t uː r aː l ɛ m	p r aɪ t ɛ r n aː t uː r aː l ɛ m
s t aː t oː m	s t a t ɪ k ʊ m
ɪ n s uː l aː r ɛ	iː n s ʊ l aː r ɛ m
b r aː k ɛ s	b r aː k aː s
kʷ a t r aː t ʊ m	kʷ a d r aː t ʊ m
d ɛ n t ɪ f r ɪ k ʊ m	d ɛ n t ɪ f r ɪ k j ʊ m
k l aː w ɪ k oː r d j ʊ m	k l aː w iː kʰ ɔ r d j ʊ m
a r k a m	a r kʰ a m
s aː t j aː r ɛ	s a t j aː r ɛ
w ɛ k s aː r ɛ	w eː k s aː r ɛ
d ɪ n ɔ s t aː r ɛ	d ɛ h ɔ n ɛ s t aː r ɛ
ɔ l ʊ m	ɔ l ʊ m
p ɛ r p ɛ t r a m r ɛ	p ɛ r p ɛ t r aː r ɛ
l ɪ g aː m ɛ n t ʊ m	l ɪ g aː m ɛ n t ʊ m
t ɔ m ʊ m	t ɔ m ʊ m
s ɛ p t ɛ n t r j oː n ɛ m	s ɛ p t ɛ n t r j oː n ɛ m
ɪ n k ɔ l ʊ m ɛ m	ɪ ŋ k ɔ l ʊ m ɛ m
f uː n ɛ s t ʊ m	f uː n ɛ s t ʊ m
d uː r aː k ɪ n ʊ m	d uː r a k ɪ n ʊ m
w ɪ b r aː t j oː n ɛ m	w ɪ b r aː t j oː n ɛ m
f l ʊ w m	f l ʊ w j ʊ m
d ɛ s ʊ l t oː r j ʊ m	d eː s ʊ l t oː r j ʊ m
w ɪ t ɪ m aː r ɛ	w ɪ k t ɪ m aː r ɛ
s ɛ sː ʊ m	s ɛ sː ʊ m
f ɛ t ɛ r ɛ	f eː t eː r ɛ
k r ɔ t aː l ʊ m	k r ɔ t a l ʊ m
d ɔ l aː r ɛ	d ɔ l aː r ɛ
r ʊ p ɛ	r uː p ɛ m
k ɛ r oː s ʊ m	k eː r oː s ʊ m
ɔ s p ɪ t aː l ɛ	h ɔ s p ɪ t aː l ɛ
b ɛ n ɪ ŋ n ʊ m	b ɛ n ɪ ŋ n ʊ m
p r ɔ d ɪ g j ʊ m s j ʊ m	p r oː d ɪ g j oː s ʊ m
k ɔ lː ʊ m	k ɔ lː ʊ m
ɔ kː ɪ d ɛ r ɛ	ɔ kː ɪ d ɛ r ɛ
ɪ l ɛ s ʊ m	ɪ lː aɪ s ʊ m
w ɪ m ɛ n t ɛ m	w ɛ h ɛ m ɛ n t ɛ m
g ɛ mː ʊ l a m	g ɛ mː ʊ l a m
a sː ɪ s ʊ m	a sː ɛ sː ʊ m
ɛ b ɛ t ɛ	h ɛ b ɛ t ɛ m
w ɔ k ɪ f ɛ r aː r ɛ	w oː k ɪ f ɛ r aː r iː
m ɛ t ɪ k ʊ l oː s ʊ m	m ɛ t ɪ k ʊ l oː s ʊ m
s k oː l ʊ m	s k ɔ p ʊ l ʊ m
t j ɔ	tʰ iː ʊ m
a kː uː s a m t oː r ɛ	a kː uː s aː t oː r ɛ m
a n ɔ d ɪ n ʊ m	a n oː d y n ɔ n
ɛ fː ɛ m ɪ n a m r ɛ	ɛ fː eː m ɪ n aː r ɛ
s ʊ r d ʊ m	s ʊ r d ʊ m
t r a n s aː k t j ʊ m n ɛ m	t r aː n s aː k t j oː n ɛ m
m a t r ɔ n aː l	m aː t r oː n aː l ɛ m
p a d ɛ lː a m	p a t ɛ lː a m
d ɛ s t ɪ t ʊ iː r ɛ m	d eː s t ɪ t ʊ ɛ r ɛ
m ɛ s ɛ r ɛ	m ɪ s k eː r ɛ
p a s t a m	p a s t a m
s ɛ n ɛ k t uː t ɛ	s ɛ n ɛ k t ʊ m
g ʊ l a m	g ʊ l a m
m a t aː sː a m	m a t a k s a m
p r ɛ k aː r ɛ	p r ɛ k aː r iː
s a l w aː r ɛ	s a l w aː r ɛ
f ɪ l j aː l ɛ	f iː l j aː l ɛ m
ɔ s k ʊ l a m t j oː n ɛ m	ɔ s k ʊ l aː t j oː n ɛ m
a fː l ɪ k t j oː n ɛ m	a fː l ɪ k t j oː n ɛ m
r uː g ɪ n oː s ʊ m	aɪ r uː g ɪ n oː s ʊ m
ɛ rː oː r ɛ m	ɛ rː oː r ɛ m
s ʊ s k r ɪ w ɛ r ɛ m	s ʊ b s k r iː b ɛ r ɛ
r ɛ s t aː r ɛ	r ɛ s t aː r ɛ
ɛ k s p ɔ r t aː t j oː n ɛ m	ɛ k s p ɔ r t aː t j oː n ɛ m
p ɔ lː aː r ʊ m	p ʊ lː aː r j ʊ m
w ɔ m ɪ t aː r ɛ	w ɔ m ɪ t aː r ɛ
a nː ʊ n k j aː r ɛ	a nː uː n t j aː r ɛ
p r ɛ g oː n ɛ m	p r aɪ k oː n ɛ m
p ɛ t r ɛ m k t ɪ l ʊ m	p ɛ t r ɔ s ɛ l iː n ʊ m
ɪ rː ɔ g aː r ɛ	ɪ rː ɔ g aː r ɛ
ɛ k s aː g ɛ r aː t j oː n ɛ m	ɛ k s a gː ɛ r aː t j oː n ɛ m
s a k ɛ r d oː t j ʊ m	s a k ɛ r d oː t j ʊ m
l ɪ m ɪ n ɛ	l iː m ɛ n
ɪ n f ɛ r m ʊ m	iː n f ɪ r m ʊ m
s ʊ b ɪ t aː n ɛ ʊ m	s ʊ b ɪ t aː n ɛu m
k ɔ m ɪ n ʊ m	k ʊ m iː n ʊ m
p ɛ r ɪ k l ɪ t aː r ɛ	p ɛ r iː k l ɪ t aː r iː
d ɛ n ɔ m ɪ n aː r ɛ	d eː n oː m ɪ n aː r ɛ
a g r aː r j ʊ m	aː g r aː r j ʊ m
p ɔ sː ɛ d ɛ r ɛ	p ɔ sː ɪ d eː r ɛ
k ɔ n w ɛ r t ɪ r ɛ m	k ɔ n w ɛ r t ɛ r ɛ
a b j ɛ k t j oː n ɛ m	a b ɪ ɛ k t j oː n ɛ m
aʊ g uː r j ʊ m	aʊ g ʊ r j ʊ m
ɛ k s ɪ gʷ ʊ m	ɛ k s ɪ gʷ ʊ m
r aː g d ɪ k ɪ n ɛ	r aː d iː k ɛ m
d ɪ sː w aː d ɛ r ɛ	d ɪ sː w aː d eː r ɛ
r eː m ʊ m	r eː m ʊ m
s ɛ k s w aː l ɪ t aː t ɛ m	s ɛ k s w aː l ɪ t aː t ɛ m
m ɛ r ɪ n d a m	m ɛ r ɛ n d a m
l a n k j aː r ɛ	l a ŋ k ɛ aː r ɛ
k ʊ n aː r ɛ	k ʊ n ɛ aː r ɛ
a kː uː s aː r ɛ	a kː uː s aː r ɛ
l a r w aː	l aː r w a m
t ɪ m oː n ɛ m	t eː m oː n ɛ m
ɪ n t ɛ r g ɛ k t j oː n ɛ m	ɪ n t ɛ r j ɛ k t j oː n ɛ m
s a n t ʊ m	s aː ŋ k t ʊ m
a nː eː k aː r ɛ	n ɛ k aː r ɛ
ɪ t aː t ɛ m	ɪ t aː t ɛ m
ɪ n j ɛ k t j oː n ɛ m	ɪ n ɪ ɛ k t j oː n ɛ m
r ɪ k s a m	r ɪ k s a m
n ɔ m ɪ n aː r ɛ	n oː m ɪ n aː r ɛ
k a r ɔ t a m	k a r oː t a m
p a r aː g r aː f ʊ m	p a r a g r a pʰ ʊ m
p r ɛ s k r ɛ w ɪ r ɛ m	p r aɪ s k r iː b ɛ r ɛ
ɪ m p ɛ r j oː s ʊ m	ɪ m p ɛ r j oː s ʊ m
k ɔ n k ɪ s ʊ m	k ɔ ŋ k ɪ d ɛ r ɛ
k ɔ s t uː m ɛ m	k oː n s ʊ eː t uː d ɪ n ɛ m
s ɛ	s eː
r ɛ l aː t ɪ w ʊ m	r ɛ l aː t iː w ʊ m
k ɔ n s ɪ ʊ m	k oː n s k j ʊ m
h aː r ʊ m	aː r j ʊ m
f ɔ r m aː r ɛ	f ɔ r aː r ɛ
s p ɛ k ʊ j ʊ m	s p ɛ k l ʊ m
t r a m ɪ t ɛ r ɛ	t r aː m ɪ tː ɛ r ɛ
k ɔ n mː ɔ t j oː n ɛ	k ɔ mː oː t j oː n ɛ m
k a p t uː r a m	k a p t uː r a m
a r g uː t j a m	a r g uː t j a m
ɔ b l aː t j oː n ɛ m	ɔ b l aː t j oː n ɛ m
g r aː d ʊ m	g r a d ʊ m
a m a n t ɛ m	a m a n t ɛ m
s a k r ʊ m	s a k r ʊ m
a ŋ d aː r ɛ	a m b ʊ l aː r ɛ
k ɛ r ɛ m oː n j aː l ɛ m	k aɪ r ɪ m oː n j aː l ɛ m
m a r m g ʊ l ʊ m	m ɛ r g ʊ m
p r ɛ d j aː l ɛ	p r aɪ d j aː l ɛ m
ɪ m aː g ɪ n ɛ	ɪ m aː g ɪ n ɛ m
a sː ɪ d ʊ m	a sː ɪ d ʊː m
p r ɛ s t a n t j a m	p r aɪ s t a n t j a m
r ɔ g aː r ɛ	r ɔ g aː r ɛ
f ɔ r t ɪ t uː d ɪ n ɛ m	f ɔ r t ɪ t uː d ɪ n ɛ m
p r ɛ j uː d ɪ k aː r ɛ m	p r aɪ j uː d ɪ k aː r ɛ
f ɛ sː aː r ɛ	f a t eː r iː
d ɛ n t aː l ɛ	d ɛ n t aː l ɛ m
s k ɔ l aː r ʊ m	s kʰ ɔ l aː r ɛ m
ɪ n w ɪ t aː t j oː n ɛ m	ɪ n w ɪ t aː t j oː n ɛ m
d ɪ sː ɔ n aː r ɛ	d ɪ sː ɔ n aː r ɛ
f ɔ r t ɛ m	f ɔ r t ɛ m
s a l ʊ b r ɛ m	s a l uː b r ɛ m
b ɛ n ɛ d ɛ t ʊ m	b ɛ n ɛ d ɪ k t ʊ m
k uː l t ʊ m	k ʊ l t ʊ m
a p r ɪ k ʊ m	a p r iː k ʊ m
a b ɪ s m ʊ m	a b y sː ʊ m
p a s t ɪ m n aː k a m	p a s t ɪ n aː k a m
k r ɛ m a m r ɛ	k r ɛ m aː r ɛ
k ɔ n f ɔ r m ɛ m	k oː n f oː r m ɛ m
a p ɛ lː ɪ t aː r ɛ	a pː ɛ lː ɪ t aː r ɛ
ɛ k s t ɛ n d ɛ r ɛ	ɛ k s t ɛ n d ɛ r ɛ
w ɛ n t r ɛ m	w ɛ n t r ɛ m
ɪ rː ɪ t aː r ɛ	ɪ rː iː t aː r ɛ
d ɛ s ʊ m ɛ r ɛ	d eː s uː m ɛ r ɛ
k a t ɛ l a m	k a t ɛ lː a m
b ɔ rː a m	b ʊ rː a m
n a t ɪ w ɪ t aː t ɛ m	n aː t iː w ɪ t aː t ɛ m
a w ɪ ʊ m	a w ɛ m
s ɛ kʷ aː k ɛ	s ɛ kʷ aː k ɛ m
a m ɛ t ɪ s t aː	a m ɛ tʰ y s t a m
r ɛ s t r ɪ ŋ g ɛ r ɛ m	r ɛ s t r ɪ ŋ g ɛ r ɛ
s p ʊ t aː r ɛ	s p uː t aː r ɛ
ɛ n s ɛ	eː n s ɛ m
ɛ m uː l ʊ m	aɪ m ʊ l ʊ m
ɔ r j ɪ ɛ n t ɛ m	ɔ r ɪ ɛ n t ɛ m
b ɛ s t j aː r j ʊ m	b eː s t j aː r j ʊ m
s kʷ aː l ɪ d ʊ m	s kʷ aː l ɪ d ʊ m
a b ɛ rː aː r ɛ	a b ɛ rː aː r ɛ
a m ɔ w ɪ b ɪ l ɛ	aː m ɔ w eː r ɛ
a d ɪ r	a dː ɛ r ɛ
a pː ɔ s t ʊ m	a pː ɔ s ɪ t ʊ m
ɔ kː uː l t aː r ɛ	ɔ kː ʊ l t aː r ɛ
d ɔ l oː	d ɔ l ʊ m
a w ɛ s ʊ m	aː w ɛ r s ʊ m
s ʊ s t ɛ n t aː k ʊ l ʊ m	s ʊ s t ɛ n t aː k ʊ l ʊ m
s t aː t ʊ iː r ɛ	s t a t ʊ ɛ r ɛ
uː m ɪ lː j a m r ɛ	h ʊ m ɪ l j aː r ɛ
g ɔ k ʊ n d ʊ m	j uː k ʊ n d ʊ m
g ɛ n t ɪ l ɛ m	g ɛ n t iː l ɛ m
s t r ɪ g ɛ m	s t r ɪ g ɛ m
ɪ n k l ɪ t ʊ m	ɪ ŋ k l ɪ t ʊ m
a l t ɛ r n aː t j ʊ m n ɛ m	a l t ɛ r n aː t j oː n ɛ m
f r aː s ɪ n ʊ m	f r a k s ɪ n ʊ m
p r ɛ k l aː r ʊ m	p r aɪ k l aː r ʊ m
l ɛ g ɛ m	l eː g ɛ m
g ɛ n j aː l ɛ	g ɛ n j aː l ɛ m
s t r j aː	s t r j a m
s ɔ n t ɛ m	s ɔ n t ɛ m
kʷ a d r ʊ p l ʊ m	kʷ a d r ʊ p l ʊ m
k ɪ p a m	k eː p a m
g ʊ ŋ g ɛ r ɛ	j ʊ ŋ g ɛ r ɛ
r ɔ m aː r ɪ n ʊ m	r oː s m a r iː n ʊ m
k ɔ n f ɪ s k aː r ɛ	k oː n f ɪ s k aː r ɛ
g ʊ b aː	j ʊ b a m
k a pː l ʊ m	k a p ʊ l ʊ m
l uː k r ʊ m	l ʊ k r ʊ m
d ɛ t ɛ r j oː r aː t j oː n ɛ m	d eː t ɛ r j oː r aː t j oː n ɛ m
aʊ r ɪ r	h aʊ r iː r ɛ
d ɪ s p oː n ɛ	d ɪ s p oː n ɛ r ɛ
ɪ n k aː p aː k	ɪ ŋ k a p aː k ɛ m
s k oː ɛ k ɛ r ɛ	ɛ k s k ɔ kʷ ɛ r ɛ
s ɛ r w ɪ t ʊ t ɛ m	s ɛ r w ɪ t uː t ɛ m
p a nː ʊ m	p a nː ʊ m
p ɛ lː aː r j ʊ m	p ɛ lː aː r j ʊ m
j oː n ɪ r ɔ s oː l ɪ m ɪ t a n ʊ m	h ɪ ɛ r ɔ s ɔ l y m iː t aː n ʊ m
p r ɛ k ɛ p t ʊ m	p r aɪ k ɛ p t ʊ m
p eː r w ɛ n ɪ r ɛ	p ɛ r w ɛ n iː r ɛ
a b ɪ t ʊ w aː l ɛ	h a b ɪ t w aː l ɛ m
a lː ʊ k k ɛ	h a lː ʊ m
w ɛ ŋ d ɪ ŋ a m t oː r ɛ m	w ɪ n d ɪ k aː t oː r ɛ m
s t aː b ɪ l k ɛ r ɛ m	s t a b ɪ l iː r ɛ
w ɪ t ʊ l ʊ	w ɪ t ʊ l ʊ m
a fː l ɛ n t j a m	a fː l ʊ ɛ n t j a m
k ɔ k s aː l ɛ	k ɔ k s aː l ɛ m
a l aː k r ɪ t aː t ɛ m	a l a k r ɪ t aː t ɛ m
f ɪ b ʊ lː a m	f iː b ʊ l a m
d ɛ n ʊ d aː r ɛ	d eː n uː d aː r ɛ
w a k ɪ lː a m t j oː n ɛ m	w a k ɪ lː aː t j oː n ɛ m
g r aː b aː t aː	g r a b aː t ʊ m
b l a n d ɪ r ɛ	b l a n d iː r iː
l ɔ ŋ g ɪ n kʷ ɪ t aː t ɛ m	l ɔ ŋ g ɪ ŋ kʷ ɪ t aː t ɛ m
a d w ɛ r b j aː l ɛ m	a d w ɛ r b j aː l ɛ m
a rː a m s	a rː h a m
p ɛ r ɪ k l oː s ʊ m	p ɛ r iː k ʊ l oː s ʊ m
