w aː k aː t j oː n ɛ m	w a k aː t j oː n ɛ m
l ʊ k b r ɪ k aː r ɛ m	l uː k ʊ b r aː r ɛ
s ʊ p ɛ r w aː k aː n ɪ ʊ m	s ʊ p ɛ r w a k ʊː m
t ɛ t r ɪ k ʊ m	t aɪ t r ɪ k ʊ m
ɪ n aʊ d ɪ t ʊ m	ɪ n aʊ d iː t ʊ m
k aː l ɪ k ɛ m	k a l ɪ k ɛ m
l a n t aː r ʊ m	l a ŋ k j aː r j ʊ m
k ɔ r ɛ	k ɔ r
k ɛ n t uː r j a m	k ɛ n t ʊ r j a m
k ɔ lː ɛ g j ʊ m	k ɔ lː eː g j ʊ m
ɔ r d ɪ n aː t oː r	ɔ r d ɪ n aː t oː r ɛ m
f aː m oː s ʊ m	f aː m oː s ʊ m
a t w ɛ r t ɪ r ɛ	a d w ɛ r t ɛ r ɛ
w ɪ p ɛ r ɪ n ʊ m	w ɪ p ɛ r iː n ʊ m
ɔ fː ɪ k ʊ m s ʊ m	ɔ fː ɪ k j oː s ʊ m
k aː s t r ʊ m	k a s t r ʊ m
a t r aː b ɪ l j aː r j ʊ m	aː t r a b iː l aː r j ʊ m
s ɔ r ɔ r ɪ t aː t ɛ m	s ɔ r oː r ɪ t aː t ɛ m
uː b ɛ r ʊ m	uː b ɛ r
t ʊ g ʊ r j ʊ m	t ʊ g ʊ r j ʊ m
d ɪ s p a r t ɪ r ɛ	d ɪ s p a r t iː r ɛ
s ʊ m aː r j ʊ m	s ʊ mː aː r j ʊ m
p ɛ r s ɪ s t ɛ r ɛ	p ɛ r s ɪ s t ɛ r ɛ
s p uː r j ʊ m	s p ʊ r j ʊ m
m a k ɛ lː ʊ m	m a k ɛ lː ʊ m
t ɪ m oː n ɛ m	t eː m oː n ɛ m
h s t r ɪ k aː r ɛ	ɛ k s t r iː k aː r ɛ
s aː t ɪ r ɪ k ʊ m	s a t ɪ r ɪ k ʊ m
d ɛ b ɛ lː aː r ɛ	d eː b ɛ lː aː r ɛ
k ɔ m p r ɪ m ɛ r ɛ	k ɔ m p r ɪ m ɛ r ɛ
p r ɔ d uː k t ɪ w ʊ m	p r oː d ʊ k t iː w ʊ m
s t ʊ p ɪ r ɛ	s t ʊ p eː r ɛ
d ɛ m oː n j ʊ m	d aɪ m ɔ n j ʊ m
g ɛ m ɛ l ʊ m	g ɛ m ɛ lː ʊ m
ɪ n k l ɔ ɪ r	ɪ ŋ k l uː d ɛ r ɛ
l ɪ t ɛ m	l iː t ɛ m
a m ʊ r k j a m	a m ʊ r k a m
s aː k r aː m ɛ n t aː l ɛ	s a k r aː m ɛ n t aː l ɛ m
k ʊ p l a m	k oː p ʊ l a m
p ɔ sː ɛ sː j oː n ɛ m	p ɔ sː ɛ sː j oː n ɛ m
aː oː d ʊ l ɪ a m	h ɪ r ʊ n d ɪ n ɛ m
t r ɪ p l ʊ m	t r ɪ p l ʊ m
l aː r w a m	l aː r w a m
l uː k s uː r j a m	l ʊ k s ʊ r j a m
p ɔ s t uː l aː t j oː n ɛ m	p ɔ s t ʊ l aː t j oː n ɛ m
b aː s j ʊ m	b aː s j ʊ m
p ɪ p aː r ɛ	p iː p aː r ɛ
p ɪ n t oː r ɛ	p ɪ k t oː r ɛ m
s ʊ g ɛ k t ʊ m	s ʊ b ɪ ɛ k t ʊ m
l ɪ m ɪ n ɛ	l iː m ɛ n
l ɛ g uː l ɛ j ʊ m	l eː g ʊ l eː j ʊ m
f ɛ r m ɛ n t ʊ m	f ɛ r m ɛ n t ʊ m
m ɔ n t aː n j oː s ʊ m	m ɔ n t aː n j oː s ʊ m
g ɛ n ɪ t ɪ w ʊ m	g ɛ n ɪ t iː w ʊ m
p uː d oː r ɛ	p ʊ d oː r ɛ m
r j ɛ aː l ɪ t aː t ɛ m	r ɛ aː l ɪ t aː t ɛ m
ɪ n f ɛ k t j oː n ɛ m	ɪ n f ɛ k t j oː n ɛ m
d ɛ n t aː t ʊ m	d ɛ n t aː t ʊ m
ɔ l oː r ɛ	ɔ l oː r ɛ m
ɪ m p a r t ɪ r ɛ	ɪ m p a r t iː r ɛ
ɪ ŋ g ɛ n ɛ d r aː r ɛ	ɪ ŋ g ɛ n ɛ r aː r ɛ
l aː p t aː r j ʊ m	l a k t aː r j ʊ m
p ɛ r ɪ t j a m	p ɛ r iː t j a m
p a l uː d oː s ʊ m	p a l uː d oː s ʊ m
b a l t ɛ ʊ m	b a l t ɛu m
n ɪ d oː r ɛ	n iː d oː r ɛ m
s a ŋ gʷ ɪ n aː r j ʊ m	s a ŋ gʷ ɪ n aː r j ʊ m
aʊ g uː r ɛ m	aʊ g ʊ r ɛ m
p ɛ r p ɛ t ʊ ɪ t aː t ɛ m	p ɛ r p ɛ t ʊ ɪ t aː t ɛ m
w ɛ t ɛ r ɛ	w ɛ t ɛ r ɛ m
t ɛ s t ʊ d ɪ n ɛ m	t ɛ s t uː d ɪ n ɛ m
r ɛ s ɛ r w aː t j oː n ɛ m	r ɛ s ɛ r w aː t j oː n ɛ m
f ɛ t oː r ɛ	f eː t oː r ɛ m
b aː lː ɛ n a m	b a lː aɪ n a m
t a k ɛ r ɛ	t a k eː r ɛ
s ʊ b j ʊ g aː r ɛ	s ʊ b j ʊ g aː r ɛ
a m aː r eː g aː r ɛ	a m aː r ɪ k aː r ɛ
s k ɛ n t ɪ lː aː r ɛ	s k ɪ n t ɪ lː aː r ɛ
n ɛ f aː r j ʊ m	n ɛ f aː r j ʊ m
s ɛ r ɪ k ʊ m	s eː r ɪ k ʊ m
p ɔ r n ɔ g r aː f j a	p ɔ r n ɔ g r a pʰ j a m
k ɪ p ɔ lː a m	k eː p ʊ lː a m
l ɪ n aː r ʊ m	l iː n aː r j ʊ m
w ɛ n t ɪ l aː t j oː n ɛ	w ɛ n t ɪ l aː t j oː n ɛ m
w ɛ ŋ d ɪ ŋ aː t oː r ɛ	w ɪ n d ɪ k aː t oː r ɛ m
kʷ aː d r ʊ m	kʷ aː d r ʊ m
p ɛ lː ɪ k a n ʊ m	p ɛ l ɛ k aː n ʊ m
s ʊ b t ɪ l ɛ	s ʊ b t iː l ɛ m
r ɛ k ɛ t a m	r ɛ k ɛ p t a m
m aː n t ɛ n ɛ r ɛ	m a n ʊ t ɛ n eː r ɛ
s uː p ɛ r b j a m	s ʊ p ɛ r b j a m
k ɔ ŋ g r ɛ g aː r ɛ	k ɔ ŋ g r ɛ g aː r ɛ
p ɛ n ʊ r j a m	p eː n uː r j a m
f ɪ k ʊ m	f iː k ʊ m
k ɔ n t r aː k t ɛ	k ɔ n t r a h ɛ r ɛ
a k ʊ m	a k ʊ m
p aː ɪ s ɛ	p aː g eː n s ɛ m
f aʊ k ɛ m	f aʊ k eː s
w ɛ r t ɪ g ɪ n oː s ʊ m	w ɛ r t iː g ɪ n oː s ʊ m
p l aː t ɛ j a m	p l a t eːa m
a sː uː m ɛ r ɛ	a sː uː m ɛ r ɛ
p r ɔ p ɪ n kʷ ɪ t aː t ɛ m	p r ɔ p ɪ ŋ kʷ ɪ t aː t ɛ m
d ɪ m ɛ n t ɪ k aː r ɛ	d eː m ɛ n t aː r ɛ
t r a n s f ɛ r ɛ r ɛ	t r aː n s f ɛ rː ɛ
f ɔ r m oː s ʊ m	f oː r m oː s ʊ m
p r ɛ w aː l eː r ɛ	p r aɪ w a l eː r ɛ
p aː r s ɪ m ɔ n j a m	p a r s ɪ m oː n j a m
a fː l ɪ g ɛ r ɛ	a fː l iː g ɛ r ɛ
k oː n ʊ m	k oː n ʊ m
ɪ n t ɛ n t j oː n ɛ m	ɪ n t ɛ n t j oː n ɛ m
g r aː t ɛ m	k r aː t ɛ m
ɪ n f a n t j a m	iː n f a n t j a m
a d ʊ n t ʊ m	a d j ʊ ŋ k t ʊ m
b ɪ k a m	b iː g a m
k ɔ n t ʊ m aː k ɛ	k ɔ n t ʊ m aː k ɛ m
ɪ n t ɛ p ɛ s t ɪ w ʊ m	ɪ n t ɛ m p ɛ s t iː w ʊ m
g ɛ m ɪ n aː r ɛ	g ɛ m ɪ n aː r ɛ
l ɛ n aː r ɛ	l ɪ ŋ n aː r iː
m eː s a m	m eː s a m
ɛ m sː ɪ kː aː r ɛ	ɛ k sː ɪ kː aː r ɛ
l a ŋ gʷ ɪ d ʊ m	l a ŋ gʷ ɪ d ʊ m
k ɛ f aː l ɪ a m	k ɛ pʰ a l aɪ a m
d ɛ s k r ɪ p t j oː n ɛ m	d eː s k r iː p t j oː n ɛ m
a b ɔ m ɪ n aː t j oː n ɛ m	a b oː m ɪ n aː t j oː n ɛ m
k ɛ n t aʊ r j a m	k ɛ n t aʊ r eːa m
l ɪ b ɛ l ʊ m	l ɪ b ɛ lː ʊ m
f ʊ r m ɪ k aː r ɛ	f ɔ r m iː k aː r ɛ
a b ɪ l ɪ t aː t ɛ m	h a b ɪ l ɪ t aː t ɛ m
r ɛ p oː n ɛ	r ɛ p oː n ɛ r ɛ
p aː r t ɛ r ʊ m	p a r t j aː r j ʊ m
a l ʊ m nː ʊ m	a l ʊ m n ʊ m
d ʊ m t oː r ɛ	d ʊ l k oː r ɛ m
a g aː r ɪ k ʊ m	a g a r ɪ k ʊ m
s ɛ n ɛ k t ʊ t ɛ	s ɛ n ɛ k t ʊ m
w ɪ n aː k a m	w iː n aː k ɛu m
a lː ɔ n d ʊ m r a m	a l aʊ d a m
n aː t uː r a m	n aː t uː r a m
m ɔ r d ɛ r ɛ	m ɔ r d eː r ɛ
s kʷ aː l ʊ m	s kʷ aː l ʊ m
a kː uː s aː r ɛ	a kː uː s aː r ɛ
p ɛ r k ɔ l aː t j ʊ m n ɛ m	p ɛ r k oː l aː t j oː n ɛ m
p ɛ r p ɛ t r aː r ɛ	p ɛ r p ɛ t r aː r ɛ
a b d uː k t j oː n ɛ m	a b d ʊ k t j oː n ɛ m
s ɪ n t ɪ p uː t	s ɪ ŋ k ɪ p ʊ t
r ʊ t aː r ɛ	r ʊ k t aː r ɛ
f aː l a ŋ g ɛ m	pʰ a l a ŋ g ɛ m
m a n d aː r ɛ	m a n d aː r ɛ
w ɪ t r ʊ m	w ɪ t r ʊ m
w ɪ n d ɪ k t a m	w ɪ n d ɪ k t a m
d ɛ w ɔ r aː t j oː n ɛ m	d eː w ɔ r aː t j oː n ɛ m
l ɛ t ʊ m	l eː k t ʊ m
s a ŋ gʷ ɪ n oː s ʊ m	s a ŋ gʷ ɪ n oː s ʊ m
w ɪ s ɪ t aː t j ɔ n ɛ	w iː s ɪ t aː t j oː n ɛ m
k ɔ n s uː m ɛ r ɛ	k oː n s uː m ɛ r ɛ
r a n k oː r ɛ	r a ŋ k oː r ɛ m
ɔ pː ɔ r t uː n ɪ t aː t ɛ m	ɔ pː ɔ r t uː n ɪ t aː t ɛ m
a m ɛ n ʊ m	a m ɔ ɪ n ʊ m
k oː s ʊ m	k ɔ k s ʊ m
p ɔ n d ɛ r aː r ɛ	p ɔ n d ɛ r aː r ɛ
p ɛ r m ɪ t ɛ r ɛ	p ɛ r m ɪ tː ɛ r ɛ
ɪ n t r ɔ d uː k t j oː n ɛ m	ɪ n t r oː d ʊ k t j oː n ɛ m
k ɪ r k ʊ l aː r ɛ	k ɪ r k ʊ l aː r ɛ m
d uː r aː r ɛ	d uː r aː r ɛ
ɪ t ɪ n ɛ r aː r j ʊ m	ɪ t ɪ n ɛ r aː r j ʊ m
g uː b a m	j ʊ b a m
l aː sː ʊ m	l a sː ʊ m
d ɪ m ɛ n s j oː n ɛ m	d iː m ɛ n s j oː n ɛ m
p ʊ ɛ r ɪ l ɛ	p ʊ ɛ r iː l ɛ m
a b s t r a h ɛ r ɛ	a b s t r a h ɛ r ɛ
b aː s ɪ l ɪ s k ʊ m	b a s ɪ l ɪ s k ʊ m
s ɔ p t w ʊ s ʊ m	s ʊ m p t ʊ oː s ʊ m
k oː n k aː w ʊ m	k ɔ ŋ k a w ʊ m
k ɔ n s t ɪ t ʊ ɪ r ɛ	k oː n s t ɪ t ʊ ɛ r ɛ
p r ɛ n ʊ m	p r aɪ ŋ n aː t ɛ m
s ɔ m ɪ aː r ɛ m	s a g m aː r j ʊ m
p ɛ p t ɪ n aː r ɛ	p ɛ k t ɪ n aː r ɛ
h t aː t oː m	s t a t ɪ k ʊ m
n ɪ m ʊ	n eː m ɪ n ɛ m
ɛ k s t ɔ r k ɛ r ɛ	ɛ k s t ɔ r kʷ eː r ɛ
g a lː ɛ t ɛ m	g a lː ɛ t a m
p aː r t ʊ m	p a r d ʊ m
b oː aː t ʊ m	b ɔ aː t ʊ m
ɛ k s p ʊ l s aː r ɛ	ɛ k s p ʊ l s aː r ɛ
a b n ɛ g aː r ɛ	a b n ɛ g aː r ɛ
m aː t r ɪ t ɪ d a m	m aː t r ɪ k iː d a m
w ɪ p t ʊ m	w iː k t ʊ m
r ɛ s k ɪ n d ɛ r ɛ	r ɛ s k ɪ n d ɛ r ɛ
s aː t ɪ s f aː k ɛ r ɛ	s a t ɪ s f a k ɛ r ɛ
k ɔ n s ɛ r w aː r ɛ	k oː n s ɛ r w aː r ɛ
d ɪ fː ʊ n d ɛ r ɛ	d ɪ fː ʊ n d ɛ r ɛ
s ɛ w ɛ r ɪ t aː t ɛ m	s ɛ w eː r ɪ t aː t ɛ m
g aʊ d j ʊ m	g aʊ d j ʊ m
fː aː s k ɪ n aː r ɛ	f a s k ɪ n aː r ɛ
k a l k aː j ʊ m	k a l k aː n ɛu m
k ʊ k ɪ n aː r ɛ	k ɔ kʷ iː n aː r ɛ
ɛ k s p a n d ɛ r ɛ	ɛ k s p a n d ɛ r ɛ
r aː p ʊ m	r aː p ʊ m
ɔ m nː ɪ s k ɛ n t ɛ m	ɔ m n ɪ s k ɪ ɛ n t ɛ m
p aː l m aː r ɛ m	p a l m aː r ɛ m
n ɛ s k j ʊ m	n ɛ s k j ʊ m
b ɔ m b aː r d a m	b ɔ m b a r d a m
p ɛ s k aː r ʊ m	p ɪ s k aː r j ʊ m
s ɛ rː ɛ g ɪ n	s ɛ rː aː g ɪ n ɛ m
n ɛ r w oː s ʊ m	n ɛ r w oː s ʊ m
p ɛ l aː g ʊ m	p ɛ l a g ʊ s
r ɪ k t ʊ m	r ɪ k t ʊ m
p ɛ r g ʊ l a m	p ɛ r g ʊ l a m
a k r ɪ t ʊ d ɛ m	aː k r ɪ t uː d ɪ n ɛ m
m ɛ n d aː k ʊ m	m ɛ n d aː k j ʊ m
m ɔ t ʊ m	m ʊ tː ʊ m
m aː r s ʊ p j ʊ m	m a r s uː p j ʊ m
ɪ n ɛ b r j aː r ɛ	ɪ n eː b r j aː r ɛ
a d w ɛ r b j aː l ɛ	a d w ɛ r b j aː l ɛ m
b ɔ r s a m	b ʊ r s a m
s ɛ p t ɛ n t r j ɔ n aː l ɛ	s ɛ p t ɛ n t r j oː n aː l ɛ m
ɔ r aː t r ɪ k ɛ	ɔ r aː t r iː k ɛ m
ɪ n w ɛ n t r ɪ k ɛ	ɪ n w ɛ n t r iː k ɛ m
d ʊ w eː r ɛ	d eː b eː r ɛ
a w ɛ n a m	a w eː n a m
a w ɛ r s j oː n ɛ	aː w ɛ r s j oː n ɛ m
l ɪ k t oː r ɛ	l iː k t oː r ɛ m
n aː t aː t oː r ɛ	n a t aː t oː r ɛ m
l ɛ n t ʊ m	l ɛ n t ʊ m
k ɔ mː ɛ t ɛ r ɛ	k ɔ mː ɪ tː ɛ r ɛ
ɔ k t aː w ʊ m	ɔ k t aː w ʊ m
a ɪ k j aː k ʊ m	aɪ g y p t j a k ʊ m
a nː ʊ t ɪ n ʊ m	a nː oː t ɪ n ʊ m
s k j ɛ m m ʊ l ʊ m	s k ɪ uː r ʊ m
a p aː r ɪ t j oː n	a pː aː r ɪ t j oː n ɛ m
a r m ʊ m s	a r m ʊ m
kʷ a t r aː t ʊ m	kʷ a d r aː t ʊ m
k ɔ n f l uː ɪ r ɛ	k oː n f l ʊ ɛ r ɛ
s ɛ rː aː r ɛ	s ɛ rː aː r ɛ
d ɪ s t ɪ lː aː r ɛ	d eː s t ɪ lː aː r ɛ
k a n d ɛ l aː b r ʊ m	k a n d eː l aː b r ʊ m
r ɛ l ɪ kʷ j a m	r eː l ɪ kʷ j aː s
p ʊ t r ɛ m	p ʊ t r ɛ m
s p ɔ s a m	s p oː n s a m
a b r ɛ w j aː r ɛ	a bː r ɛ w j aː r ɛ
g aː n ʊ m r ɛ	g a n aː r ɛ
b r ɔ kː ʊ m	b r ɔ kː ʊ m
aː k eː r ʊ m	aː k r ɛ m
m ɛ s t ɛ r ɛ	m ɪ n ɪ s t ɛ r j ʊ m
l aː b ɔ r aː r ɛ	l a b oː r aː r ɛ
h ɛ l k n ɛ	iː l ɪ k ɛ m
uː m ɪ d ʊ m	h uː m ɪ d ʊ m
p ɛ r d r ɪ k	p ɛ r d iː k ɛ m
eː r ɛ d ɛ	h eː r eː d ɛ m
s aː l aː t ɪ t aː t ɛ m	s a l aː k ɪ t aː t ɛ m
s aː t ɛ lː ɪ t ɛ	s a t ɛ lː ɪ t ɛ m
a t ɔ r m ɛ t ɛ r ɛ	a dː ɔ r m iː s k ɛ r ɛ
a d ɪ k r ɛ	a dː iː k ɛ r ɛ
l uː k s ʊ m	l uː k s ʊ m
p ɛ r s ɛ k ʊ t oː r ɛ	p ɛ r s ɛ k uː t oː r ɛ m
n aʊ s j aː b ʊ n d ʊ m	n aʊ s ɛ aː b ʊ n d ʊ m
m ɪ l ɛ m	m iː lː j a
ɔ s t ɛ n t aː r ɛ	ɔ s t ɛ n t aː r ɛ
l uː p r ɪ k aː r ɛ	l uː b r ɪ k aː r ɛ
m ɪ t ɪ g aː r ɛ	m iː t ɪ g aː r ɛ
ɛ r ɛ t ɪ k ɛ m	h aɪ r ɛ t ɪ k ʊ m
k aː l ɛ f aː k t j oː n ɛ m ɛ	k a l ɛ f a k t j oː n ɛ m
f r uː k t ʊ m	f r uː k t ʊ m
k l aː r ɪ t aː t ɛ m	k l aː r ɪ t aː t ɛ m
ɔ r p ɪ m ɛ n t ʊ m	aʊ r ɪ p ɪ g m ɛ n t ʊ m
f uː n ɛ b r ɛ m	f uː n ɛ b r ɛ m
d ɛ l ɛ k t aː t j oː n ɛ m	d eː l ɛ k t aː t j oː n ɛ m
m ɪ l j aː r j ʊ m	m iː lː j aː r j ʊ m
k ɛ d r ʊ m	k ɛ d r ʊ m
a d m ɪ n ɪ k ʊ l ʊ m	a d m ɪ n ɪ k ʊ l ʊ m
g ɛ ɔ m ɛ t r j a m	g ɛ oː m ɛ t r j a m
s t r aː g ʊ m	s t r aː g ɛ m
p ɛ r ɪ g ʊ n t aː r ɛ	p ɛ r k ɔ n t aː r iː
l a n oː s ʊ m	l aː n oː s ʊ m
b ɛ n ɛ f aː k r ɛ	b ɛ n ɛ f a k ɛ r ɛ
t r a n s k r ɪ w ɛ r ɛ	t r aː n s k r iː b ɛ r ɛ
d ɛ rː ʊ ɛ r ɛ	d iː r ʊ ɛ r ɛ
ɛ k s t r aː ɔ r d ɪ n aː r j ʊ m	ɛ k s t r aː ɔ r d ɪ n aː r j ʊ m
s ɪ ɪ lː aː r ɛ	s ɪ g ɪ lː aː r ɛ
d ɛ l ɪ b ɛ r aː t j oː n ɛ m	d eː l iː b ɛ r aː t j oː n ɛ m
j uː s t ɪ f ɪ k aː t j oː n ɛ	j uː s t ɪ f ɪ k aː t j oː n ɛ m
f aː b ɛ lː a m	f aː b ɛ lː a m
ɔ s p ɪ t j ʊ m	h ɔ s p ɪ t j ʊ m
k ɔ r j aː k ɛ ʊ m	k ɔ r j a k ɛu m
f ɪ sː j oː n ɛ m	f ɪ sː j oː n ɛ m
a s p ɛ r g ɛ r ɛ	a s p ɛ r g ɛ r ɛ
t ɛ k m a m	tʰ eː k a m
p ɪ t ʊ m	p iː k ʊ m
a n ɛ ʊ m	a ŋ n ɛ lː ʊ m
a m p l ɪ t uː d ɪ	a m p l ɪ t uː d ɪ n ɛ m
d ɛ s uː m ɛ r ɛ	d eː s uː m ɛ r ɛ
r ɛ p uː ŋ n aː r ɛ	r ɛ p ʊ ŋ n aː r ɛ
ɪ n k r ɛ m ɛ n t ʊ m	ɪ ŋ k r eː m ɛ n t ʊ m
d ɛ n ʊ n k ɛ m t j aː k ɛ m n	d eː n ʊ n t j aː t j oː n ɛ m
d ɛ n t aː l ɛ	d ɛ n t aː l ɛ m
s aː n t ʊ m r ɛ t a m	s a t ʊ r eː j a m
a l k ɛ m	a l k ɛ m
k ɔ n k ɪ nː ɪ t a m t ɛ m	k ɔ ŋ k ɪ nː ɪ t aː t ɛ m
d ɪ s t r aː k t j oː n ɛ m	d ɪ s t r a k t j oː n ɛ m
k aː rː ɪ k k ɛ m	k aː r ɪ k ɛ m
k ɔ n s ɔ l ɪ d aː r ɛ	k oː n s ɔ l ɪ d aː r ɛ
m ʊ n g ɪ r ɛ	m ʊ l g eː r ɛ
p ɛ l aː ŋ b ʊ l aː r ɛ	p ɛ r a m b ʊ l aː r ɛ
m p ɪ l aː r ɛ	p ɪ l aː r ɛ
s ɛ m ʊ w eː r ɛ	eː m ɔ w eː r ɛ
a k t ʊ w aː l ɛ	a k t w aː l ɛ m
s ɔ r ɪ k ɛ	s oː r ɪ k ɛ m
p r ɪ n k ɪ p aː l ɪ t aː t ɛ m	p r ɪ ŋ k ɪ p aː l ɪ t aː t ɛ m
s a g ɪ t aː r j ʊ m	s a g ɪ tː aː r j ʊ m
a b l aː k t aː t j oː n ɛ m	a b l a k t aː t j oː n ɛ m
f ɛ l ɪ k ɛ	f eː l iː k ɛ m
k ɔ l oː n j a	k ɔ l oː n j a m
f l aː t ʊ m	f l aː t ʊ m
m ɛ n aː k aː	m ɪ n aː k ɛ m
p aː r ɪ ɛ t aː l ɛ	p a r ɪ ɛ t aː l ɛ m
m ʊ l t aː r ɛ	m ʊ l t aː r ɛ
f ɪ g uː r a m	f ɪ g uː r a m
a n aː l ɪ s iː	a n a l y s ɛ m
b ʊ lː ɪ r ɛ	b ʊ lː iː r ɛ
k ɔ m p l ɛ m ɛ n t ʊ m	k ɔ m p l eː m ɛ n t ʊ m
d ɪ ŋ n aː t j oː n ɛ m	d ɪ ŋ n aː t j oː n ɛ m
n ɛ r w ʊ m	n ɛ r w ʊ m
s ɛ n s ʊ m	s eː n s ʊ m
k ɔ kː ɪ n ɪ l a m	k ɔ kː ɪ n a m
d ɛ t ɛ s t aː t j oː n ɛ m	d eː t ɛ s t aː t j oː n ɛ m
s aː ɛ m w ɛ m	s w aː w ɛ m
p j ɛ a n a	p aɪ aː n ɛ m
k ɔ k ʊ m	k ɔ kʷ ʊ m
s ɪ k ɔ f a n t a m	s yː k ɔ pʰ a n t a m
r ʊ t ɪ l aː r ɛ	r ʊ t ɪ l aː r ɛ
ɪ m p ɛ t r aː r ɛ	ɪ m p ɛ t r aː r ɛ
ɪ n ʊ l t ʊ m	ɪ n ʊ l t ʊ m
s aː l ɪ w aː r ɛ	s a l iː w aː r ɛ
b uː k j ɪ n ɛ	b uː k ɪ n ʊ m
ɛ k s t aː s ɛ	ɛ k s t a s ɛ m
r ɛ f l ɛ t ɪ r ɛ	r ɛ f l ɛ k t ɛ r ɛ
s ɛ n s w aː l ɪ t aː t ɛ m	s ɛ n s w aː l ɪ t aː t ɛ m
r ɛ t r aː k t aː r ɛ	r ɛ t r a k t aː r ɛ
t ɛ s t ɪ m oː n j ʊ m	t ɛ s t ɪ m oː n j ʊ m
f l uː w m	f l ʊ w j ʊ m
p ɔ m ɪ f ɛ r ʊ m	p oː m ɪ f ɛ r ʊ m
d aː t a m	d a t a
a n ɛ m ɔ n ɛ	a n ɛ m oː n eː n
f ʊ s t a m	f ʊ s t a m
ɪ n w ɛ s t ɪ r ɛ	ɪ n w ɛ s t iː r ɛ
s aː p eː r ɛ	s a p ɛ r ɛ
kʷ aː l ɪ f ɪ k aː r ɛ	kʷ aː l ɪ f ɪ k aː r ɛ
k ɔ lː aʊ d aː r ɛ	k ɔ lː aʊ d aː r ɛ
f ʊ l ɛ k a m	f ʊ l ɪ k a m
a pː ɔ r t aː r ɛ	a pː ɔ r t aː r ɛ
s p ɔ r t a m	s p ɔ r t a m
p a l oː	p aː l ʊ m
ɪ m p ɛ r aː r ɛ	ɪ m p ɛ r aː r ɛ
ɛ lː ɪ p sː ɪ	ɛ lː iː p s ɪ n
k ɪ p r ɛ s ʊ m	k ʊ p r ɛ sː ʊ m
w ɪ r g ʊ l a m	w ɪ r g ʊ l a m
k j oː n ɛ	t j oː n ɛ m
r ɛ g aː r ɛ	r ɪ g aː r ɛ
l aː p ɪ d aː r ɛ	l a p ɪ d aː r ɛ
l ʊ k ɛ lː ʊ m	l ɔ k ɛ lː ʊ m
g l ɔ r j ɔ s ɪ sː ɪ m ʊ m	g l oː r j oː s ɪ sː ɪ m ʊ m
t aː l ʊ t ɛ m	t aː l ʊ m
p r ɔ f ɛ r ɪ r ɛ	p r oː f ɛ rː ɛ
p uː lː uː l aː r ɛ	p ʊ lː ʊ l aː r ɛ
w ɛ r s ɪ f ɪ k aː r ɛ	w ɛ r s ɪ f ɪ k aː r ɛ
a ŋ d aː r ɛ	a m b ʊ l aː r ɛ
k ɔ m ʊ n j oː n ɛ m	k ɔ mː uː n iː r ɛ
ɪ rː ʊ m p ɛ r ɛ	ɪ rː ʊ m p ɛ r ɛ
kʷ ɛ r ɛ lː a m	kʷ ɛ r eː l a m
s k r ʊ t aː r ɛ	s k r uː t aː r ɛ
p aː l ʊ s t r ɛ m	p a l uː s t r ɛ m
a r d ʊ m	a r d ʊː m
a b s t ɛ m j ʊ m	a b s t eː m j ʊ m
ɪ r aː t ʊ m	iː r aː t ʊ m
ɛ n d ʊ r ɛ t ɛ r	ɪ n d uː r eː s k ɛ r ɛ
a gː r aː w aː r ɛ	a gː r a w aː r ɛ
m ʊ l ɪ n ʊ m	m ɔ l iː n ʊ m
ɔ b s ɛ r w aː r ɛ	ɔ b s ɛ r w aː r ɛ
r ɛ w ɛ r ɛ n t ɛ m	r ɛ w ɛ r ɛ n t ɛ m
l oː k aː r ɛ	l ɔ k aː r ɛ
d ɔ m ɪ k ɪ l j ʊ m	d ɔ m ɪ k ɪ l j ʊ m
a r k j a m	a r kʰ j a m
p ɪ ŋ kʷ ɛ	p ɪ ŋ gʷ ɛ m
p r ɔ f ɛ t j a m	p r ɔ pʰ eː t iː a m
s p ɛ l t a m	s p ɛ l t a m
p aː l p ɪ t aː t j oː n ɛ m	p a l p ɪ t aː t j oː n ɛ m
w ɛ n ɛ r aː r ɛ	w ɛ n ɛ r aː r iː
f r aː s k ʊ m	f l a s k oː n ɛ m
a b uː s ɪ w ʊ m	a b uː s iː w ʊ m
w aː g aː b ʊ n d ʊ m	w a g aː b ʊ n d ʊ m
a r t ɪ m ɛ	a gː ɛ r ɛ m
l ɔ ʊ d a t ɔ r ɛ	l aʊ d aː t oː r ɛ m
a s t ɔ r ɛ	a s t ʊ r ɛ m
ɛ k s k l uː d ɛ r ɛ	ɛ k s k l uː d ɛ r ɛ
k ʊ l ɛu w r a m	k ɔ l ʊ b r a m
m aː s k ʊ l ɪ n ʊ m	m a s k ʊ l iː n ʊ m
a l ɛ m	aː l ɛ m
a b ɛ t ʊ m	a b ɪ eː t ɛ m
kʷ ɛ s t j oː n ɛ	kʷ aɪ s t j oː n ɛ m
s ɪ l ɪ k ɛ m	s ɪ l ɪ k ɛ m
p aː k ɪ f ɪ k ʊ m	p aː k ɪ f ɪ k ʊ m
a s ɪ l ʊ m	a s y l ʊ m
a m ɔ w ɪ b ɪ l ɛ	aː m ɔ w eː r ɛ
d ɛ t ɛ r g ɛ r ɛ	d eː t ɛ r g eː r ɛ
s ʊ p ɛ r w aː k aː n ɛ ʊ m	s ʊ p ɛ r w a k aː n ɛu m
p uː p a m	p uː p a m
d ɔ l oː s ʊ m	d ɔ l oː s ʊ m
ɔ kː ʊ rː ɛ r ɛ	ɔ kː ʊ rː ɛ r ɛ
k aː r a m	k a r a m
ɛ k ʊ m	ɛ kː ʊ m
s p oː ŋ g a m	s p ɔ ŋ g j a m
s uː k k j n aː r ɛ	s uː g ɛ r ɛ
p r ɛ s aː r ɛ	p r ɛ t j aː r ɛ
h t aː t ɛ m	t a t ɛ m
f l aː k ʊ m	f l a kː ʊ m
t r aː t aː t ʊ m	t r a k t aː t ʊ m
